"CHROM","POS","REF","ALT","AD_REF.D2_F2_TT","AD_ALT.D2_F2_TT","DP.LOW","GQ.LOW","AD_REF.D2_F2_tt","AD_ALT.D2_F2_tt","DP.HIGH","GQ.HIGH","SNPindex.HIGH","SNPindex.LOW","REF_FRQ","deltaSNP"
"Chr01","344698","C","T",19,18,37,155,14,23,37,137,0.621621621621622,0.486486486486487,0.445945945945946,0.135135135135135
"Chr01","2943267","T","A",44,42,86,140,66,51,117,140,0.435897435897436,0.488372093023256,0.541871921182266,-0.0524746571258199
"Chr01","3751995","T","C",8,4,12,55,15,10,25,77,0.4,0.333333333333333,0.621621621621622,0.0666666666666667
"Chr01","4720049","G","A",64,51,115,142,80,38,118,142,0.322033898305085,0.443478260869565,0.618025751072961,-0.12144436256448
"Chr01","5567202","G","A",51,45,96,160,39,53,92,160,0.576086956521739,0.46875,0.478723404255319,0.107336956521739
"Chr01","6237654","A","G",5,11,16,3,10,20,30,42,0.666666666666667,0.6875,0.326086956521739,-0.0208333333333334
"Chr01","7047748","A","G",27,30,57,137,31,30,61,138,0.491803278688525,0.526315789473684,0.491525423728814,-0.0345125107851596
"Chr01","8720466","T","C",108,96,204,139,136,128,264,139,0.484848484848485,0.470588235294118,0.521367521367521,0.0142602495543672
"Chr01","8728296","A","T",69,59,128,160,66,88,154,160,0.571428571428571,0.4609375,0.478723404255319,0.110491071428571
"Chr01","9396322","G","A",17,17,34,146,21,22,43,146,0.511627906976744,0.5,0.493506493506494,0.0116279069767442
"Chr01","10361552","A","G",78,46,124,160,96,73,169,160,0.431952662721893,0.370967741935484,0.593856655290102,0.0609849207864096
"Chr01","10710975","G","A",24,20,44,160,24,34,58,160,0.586206896551724,0.454545454545455,0.470588235294118,0.13166144200627
"Chr01","10972432","G","A",31,49,80,160,32,47,79,160,0.594936708860759,0.6125,0.39622641509434,-0.0175632911392406
"Chr01","12616225","G","A",37,28,65,143,59,49,108,143,0.453703703703704,0.430769230769231,0.554913294797688,0.0229344729344729
"Chr01","12616497","T","G",64,47,111,144,59,56,115,144,0.48695652173913,0.423423423423423,0.544247787610619,0.063533098315707
"Chr01","12616756","T","C",55,63,118,147,80,58,138,147,0.420289855072464,0.533898305084746,0.52734375,-0.113608450012282
"Chr01","12616805","A","T",74,58,132,160,80,67,147,160,0.45578231292517,0.439393939393939,0.551971326164875,0.0163883735312307
"Chr01","12617582","A","G",78,57,135,160,59,84,143,160,0.587412587412587,0.422222222222222,0.492805755395683,0.165190365190365
"Chr01","12617785","C","T",82,60,142,160,94,93,187,160,0.497326203208556,0.422535211267606,0.534954407294833,0.0747909919409505
"Chr01","12617905","T","C",66,67,133,160,68,74,142,160,0.52112676056338,0.503759398496241,0.487272727272727,0.0173673620671396
"Chr01","12618051","G","A",59,44,103,139,70,68,138,139,0.492753623188406,0.427184466019417,0.535269709543568,0.0655691571689884
"Chr01","12618230","T","C",46,36,82,144,53,52,105,144,0.495238095238095,0.439024390243902,0.529411764705882,0.0562137049941928
"Chr01","12618741","C","T",49,56,105,160,61,70,131,160,0.534351145038168,0.533333333333333,0.466101694915254,0.00101781170483461
"Chr01","12618821","G","A",71,61,132,152,67,73,140,152,0.521428571428571,0.462121212121212,0.507352941176471,0.0593073593073594
"Chr01","12618895","C","G",77,70,147,160,79,78,157,160,0.496815286624204,0.476190476190476,0.513157894736842,0.0206248104337277
"Chr01","12619687","G","T",66,85,151,160,89,87,176,160,0.494318181818182,0.562913907284768,0.474006116207951,-0.0685957254665864
"Chr01","12619918","C","G",29,42,71,160,42,23,65,160,0.353846153846154,0.591549295774648,0.522058823529412,-0.237703141928494
"Chr01","12620033","C","T",18,38,56,141,37,26,63,141,0.412698412698413,0.678571428571429,0.46218487394958,-0.265873015873016
"Chr01","12620102","C","T",23,42,65,145,41,25,66,145,0.378787878787879,0.646153846153846,0.488549618320611,-0.267365967365967
"Chr01","12620578","A","C",23,21,44,160,20,32,52,160,0.615384615384615,0.477272727272727,0.447916666666667,0.138111888111888
"Chr01","12620620","A","G",15,17,32,151,14,21,35,151,0.6,0.53125,0.432835820895522,0.06875
"Chr01","12620681","A","G",27,32,59,160,31,43,74,160,0.581081081081081,0.542372881355932,0.43609022556391,0.0387081997251488
"Chr01","12638456","G","A",54,54,108,143,64,67,131,143,0.511450381679389,0.5,0.493723849372385,0.0114503816793893
"Chr01","12641556","G","A",24,40,64,160,38,35,73,160,0.479452054794521,0.625,0.452554744525547,-0.145547945205479
"Chr01","12642380","C","T",8,19,27,138,15,11,26,147,0.423076923076923,0.703703703703704,0.433962264150943,-0.280626780626781
"Chr01","12642513","C","G",4,9,13,97,7,9,16,160,0.5625,0.692307692307692,0.379310344827586,-0.129807692307692
"Chr01","12642820","A","G",14,37,51,142,21,32,53,142,0.60377358490566,0.725490196078431,0.336538461538462,-0.121716611172771
"Chr01","12643048","C","T",53,44,97,148,39,42,81,148,0.518518518518518,0.45360824742268,0.51685393258427,0.0649102710958381
"Chr01","12647496","A","G",22,27,49,160,32,31,63,160,0.492063492063492,0.551020408163265,0.482142857142857,-0.0589569160997732
"Chr01","12738725","G","C",19,9,28,160,18,7,25,130,0.28,0.321428571428571,0.69811320754717,-0.0414285714285714
"Chr01","13174134","T","G",59,86,145,139,80,101,181,139,0.558011049723757,0.593103448275862,0.426380368098159,-0.0350923985521051
"Chr01","13229536","G","A",35,48,83,160,48,55,103,160,0.533980582524272,0.578313253012048,0.446236559139785,-0.0443326704877763
"Chr01","14498218","C","T",15,28,43,0,26,24,50,124,0.48,0.651162790697674,0.440860215053763,-0.171162790697674
"Chr01","15978913","G","A",NA,NA,NA,NA,0,4,4,13,1,NA,NA,NA
"Chr01","15978928","C","T",NA,NA,NA,NA,0,4,4,13,1,NA,NA,NA
"Chr01","16231209","G","A",11,9,20,3,9,10,19,26,0.526315789473684,0.45,0.512820512820513,0.0763157894736842
"Chr01","16285049","C","T",12,9,21,0,13,4,17,5,0.235294117647059,0.428571428571429,0.657894736842105,-0.19327731092437
"Chr01","17781204","T","C",30,28,58,160,42,45,87,160,0.517241379310345,0.482758620689655,0.496551724137931,0.0344827586206897
"Chr01","18024251","G","T",52,47,99,141,58,70,128,141,0.546875,0.474747474747475,0.484581497797357,0.0721275252525252
"Chr01","22538536","A","G",9,19,28,70,11,21,32,79,0.65625,0.678571428571429,0.333333333333333,-0.0223214285714286
"Chr01","23303933","C","T",44,32,76,160,50,47,97,160,0.484536082474227,0.421052631578947,0.543352601156069,0.0634834508952795
"Chr01","23496823","A","T",28,24,52,160,24,39,63,160,0.619047619047619,0.461538461538462,0.452173913043478,0.157509157509158
"Chr01","23798079","G","A",19,27,46,160,40,27,67,160,0.402985074626866,0.58695652173913,0.52212389380531,-0.183971447112265
"Chr01","23839995","T","G",36,31,67,160,53,30,83,160,0.36144578313253,0.462686567164179,0.593333333333333,-0.101240784031649
"Chr01","24755163","C","T",20,0,20,82,14,0,14,64,0,0,1,0
"Chr01","25302710","C","T",39,40,79,160,63,37,100,160,0.37,0.506329113924051,0.569832402234637,-0.136329113924051
"Chr01","25349052","T","C",4,1,5,18,4,2,6,21,0.333333333333333,0.2,0.727272727272727,0.133333333333333
"Chr01","26146299","C","T",6,10,16,57,10,7,17,3,0.411764705882353,0.625,0.484848484848485,-0.213235294117647
"Chr01","26156486","G","A",18,18,36,142,24,10,34,76,0.294117647058824,0.5,0.6,-0.205882352941176
"Chr01","26255147","C","T",10,1,11,40,7,1,8,29,0.125,0.0909090909090909,0.894736842105263,0.0340909090909091
"Chr01","26255172","T","C",10,1,11,38,7,1,8,28,0.125,0.0909090909090909,0.894736842105263,0.0340909090909091
"Chr01","27622188","G","A",12,12,24,149,16,8,24,149,0.333333333333333,0.5,0.583333333333333,-0.166666666666667
"Chr01","29094283","C","T",23,21,44,118,28,33,61,148,0.540983606557377,0.477272727272727,0.485714285714286,0.0637108792846498
"Chr01","29207386","T","G",12,2,14,31,13,8,21,41,0.380952380952381,0.142857142857143,0.714285714285714,0.238095238095238
"Chr01","29264449","G","A",55,54,109,160,68,52,120,160,0.433333333333333,0.495412844036697,0.537117903930131,-0.0620795107033639
"Chr01","30248653","T","C",63,83,146,160,135,71,206,160,0.344660194174757,0.568493150684932,0.5625,-0.223832956510174
"Chr01","30926488","G","A",7,2,9,27,5,4,9,1,0.444444444444444,0.222222222222222,0.666666666666667,0.222222222222222
"Chr01","31453754","G","T",12,0,12,49,5,2,7,27,0.285714285714286,0,0.894736842105263,0.285714285714286
"Chr01","32079675","C","A",16,32,48,160,22,14,36,160,0.388888888888889,0.666666666666667,0.452380952380952,-0.277777777777778
"Chr01","32079676","G","A",32,16,48,160,15,22,37,160,0.594594594594595,0.333333333333333,0.552941176470588,0.261261261261261
"Chr01","33587714","C","T",57,52,109,143,79,77,156,143,0.493589743589744,0.477064220183486,0.513207547169811,0.0165255234062573
"Chr01","34182892","A","T",92,94,186,160,89,121,210,160,0.576190476190476,0.505376344086022,0.457070707070707,0.0708141321044546
"Chr01","35112602","T","C",44,67,111,160,93,50,143,160,0.34965034965035,0.603603603603604,0.539370078740158,-0.253953253953254
"Chr01","36377367","A","G",14,25,39,0,20,29,49,7,0.591836734693878,0.641025641025641,0.386363636363636,-0.0491889063317635
"Chr01","36469162","G","A",15,21,36,147,38,28,66,147,0.424242424242424,0.583333333333333,0.519607843137255,-0.159090909090909
"Chr01","36672145","G","T",4,4,8,0,6,7,13,40,0.538461538461538,0.5,0.476190476190476,0.0384615384615384
"Chr01","37751688","C","G",8,9,17,21,0,12,12,39,1,0.529411764705882,0.275862068965517,0.470588235294118
"Chr01","38436594","G","A",0,1,1,5,1,7,8,26,0.875,1,0.111111111111111,-0.125
"Chr01","39405870","G","A",70,62,132,160,65,112,177,160,0.632768361581921,0.46969696969697,0.436893203883495,0.163071391884951
"Chr01","40077801","A","G",50,44,94,160,60,67,127,160,0.52755905511811,0.468085106382979,0.497737556561086,0.0594739487351315
"Chr01","48829652","A","T",77,81,158,160,105,95,200,160,0.475,0.512658227848101,0.508379888268156,-0.0376582278481012
"Chr01","50120990","C","T",13,1,14,25,6,0,6,27,0,0.0714285714285714,0.95,-0.0714285714285714
"Chr01","50583682","T","A",23,20,43,95,26,30,56,79,0.535714285714286,0.465116279069767,0.494949494949495,0.0705980066445183
"Chr01","51182399","G","A",9,12,21,140,5,18,23,56,0.782608695652174,0.571428571428571,0.318181818181818,0.211180124223603
"Chr01","53246216","G","C",25,28,53,160,33,19,52,139,0.365384615384615,0.528301886792453,0.552380952380952,-0.162917271407837
"Chr01","53847625","C","T",27,37,64,153,40,38,78,153,0.487179487179487,0.578125,0.471830985915493,-0.0909455128205128
"Chr01","56466826","G","T",15,25,40,112,26,21,47,141,0.446808510638298,0.625,0.471264367816092,-0.178191489361702
"Chr01","57048537","C","T",1,1,2,4,2,0,2,12,0,0.5,0.75,-0.5
"Chr01","57293246","C","T",20,22,42,160,24,24,48,160,0.5,0.523809523809524,0.488888888888889,-0.0238095238095238
"Chr01","58735738","T","C",4,22,26,55,11,34,45,58,0.755555555555556,0.846153846153846,0.211267605633803,-0.0905982905982906
"Chr01","59317706","A","T",53,60,113,154,69,92,161,154,0.571428571428571,0.530973451327434,0.445255474452555,0.0404551201011377
"Chr01","61303227","A","G",4,4,8,8,10,5,15,6,0.333333333333333,0.5,0.608695652173913,-0.166666666666667
"Chr01","61478093","G","C",0,1,1,2,1,0,1,11,0,1,0.5,-1
"Chr01","62114296","A","C",43,56,99,160,44,57,101,160,0.564356435643564,0.565656565656566,0.435,-0.00130013001300133
"Chr01","63132535","G","A",7,10,17,33,16,4,20,38,0.2,0.588235294117647,0.621621621621622,-0.388235294117647
"Chr01","64361116","T","A",46,52,98,141,63,64,127,141,0.503937007874016,0.530612244897959,0.484444444444444,-0.0266752370239435
"Chr01","65224564","G","A",81,48,129,140,74,87,161,140,0.540372670807453,0.372093023255814,0.53448275862069,0.168279647551639
"Chr01","73970216","A","G",69,60,129,160,95,71,166,160,0.427710843373494,0.465116279069767,0.555932203389831,-0.0374054356962735
"Chr01","77487922","T","C",13,15,28,160,18,10,28,160,0.357142857142857,0.535714285714286,0.553571428571429,-0.178571428571429
"Chr01","78934052","G","A",10,4,14,24,11,5,16,0,0.3125,0.285714285714286,0.7,0.0267857142857143
"Chr01","78934053","C","T",4,10,14,32,5,11,16,0,0.6875,0.714285714285714,0.3,-0.0267857142857143
"Chr01","79052675","C","T",20,12,32,160,15,15,30,160,0.5,0.375,0.564516129032258,0.125
"Chr01","79053548","A","G",43,48,91,140,66,65,131,140,0.49618320610687,0.527472527472527,0.490990990990991,-0.0312893213656573
"Chr01","79053872","T","C",88,68,156,137,111,82,193,137,0.424870466321244,0.435897435897436,0.570200573065903,-0.0110269695761924
"Chr01","79054218","C","A",81,95,176,139,96,120,216,139,0.555555555555556,0.539772727272727,0.451530612244898,0.0157828282828283
"Chr01","79055107","A","G",47,60,107,140,61,82,143,140,0.573426573426573,0.560747663551402,0.432,0.0126789098751716
"Chr01","79055581","A","G",73,100,173,160,123,107,230,160,0.465217391304348,0.578034682080925,0.486352357320099,-0.112817290776577
"Chr01","79055868","A","T",65,74,139,140,86,80,166,140,0.481927710843373,0.532374100719424,0.495081967213115,-0.050446389876051
"Chr01","79055940","A","G",70,79,149,136,101,91,192,136,0.473958333333333,0.530201342281879,0.501466275659824,-0.0562430089485459
"Chr01","79056668","T","C",80,73,153,137,92,64,156,137,0.41025641025641,0.477124183006536,0.55663430420712,-0.0668677727501257
"Chr01","79056884","T","C",83,81,164,160,77,116,193,160,0.601036269430052,0.49390243902439,0.448179271708683,0.107133830405662
"Chr01","79057099","T","C",75,95,170,136,74,89,163,136,0.54601226993865,0.558823529411765,0.447447447447447,-0.0128112594731145
"Chr01","79057312","C","A",59,67,126,160,56,70,126,160,0.555555555555556,0.531746031746032,0.456349206349206,0.0238095238095238
"Chr01","79057697","G","A",14,20,34,160,24,16,40,160,0.4,0.588235294117647,0.513513513513513,-0.188235294117647
"Chr01","79057916","G","T",8,14,22,160,23,16,39,160,0.41025641025641,0.636363636363636,0.508196721311475,-0.226107226107226
"Chr01","79059007","T","A",52,62,114,141,37,54,91,141,0.593406593406593,0.543859649122807,0.434146341463415,0.0495469442837864
"Chr01","79059164","C","T",71,60,131,160,86,46,132,160,0.348484848484849,0.458015267175573,0.596958174904943,-0.109530418690724
"Chr01","79084204","T","C",67,42,109,159,58,60,118,159,0.508474576271186,0.385321100917431,0.550660792951542,0.123153475353755
"Chr01","79088562","T","C",66,88,154,160,76,102,178,160,0.573033707865168,0.571428571428571,0.427710843373494,0.0016051364365971
"Chr01","79088774","T","C",55,68,123,136,72,106,178,136,0.595505617977528,0.552845528455285,0.421926910299003,0.0426600895222435
"Chr01","79091119","G","T",80,36,116,147,80,58,138,147,0.420289855072464,0.310344827586207,0.62992125984252,0.109945027486257
"Chr01","79091708","T","A",89,69,158,142,96,85,181,142,0.469613259668508,0.436708860759494,0.545722713864307,0.0329043989090146
"Chr01","79091985","T","A",30,34,64,160,41,35,76,160,0.460526315789474,0.53125,0.507142857142857,-0.0707236842105263
"Chr01","79092267","A","C",65,62,127,160,63,73,136,160,0.536764705882353,0.488188976377953,0.486692015209125,0.0485757295044001
"Chr01","79092599","T","A",61,76,137,141,101,97,198,141,0.48989898989899,0.554744525547445,0.483582089552239,-0.0648455356484554
"Chr01","79093437","C","A",103,56,159,147,95,80,175,147,0.457142857142857,0.352201257861635,0.592814371257485,0.104941599281222
"Chr01","79093931","T","C",68,68,136,141,92,56,148,141,0.378378378378378,0.5,0.563380281690141,-0.121621621621622
"Chr01","79094178","A","C",37,68,105,139,68,85,153,139,0.555555555555556,0.647619047619048,0.406976744186047,-0.0920634920634921
"Chr01","79094300","G","C",64,73,137,160,105,72,177,160,0.406779661016949,0.532846715328467,0.538216560509554,-0.126067054311518
"Chr01","79094370","G","A",55,70,125,160,89,74,163,160,0.45398773006135,0.56,0.5,-0.10601226993865
"Chr01","79095157","C","T",66,72,138,160,107,77,184,160,0.418478260869565,0.521739130434783,0.537267080745342,-0.103260869565217
"Chr01","79095435","T","G",55,55,110,160,62,89,151,160,0.589403973509934,0.5,0.448275862068966,0.0894039735099338
"Chr01","79095518","T","C",65,68,133,142,88,83,171,142,0.485380116959064,0.511278195488722,0.503289473684211,-0.0258980785296575
"Chr01","79096121","G","A",84,72,156,160,101,103,204,160,0.504901960784314,0.461538461538462,0.513888888888889,0.0433634992458521
"Chr01","79096428","A","G",60,66,126,160,67,79,146,160,0.541095890410959,0.523809523809524,0.466911764705882,0.0172863666014351
"Chr01","79096490","A","T",68,78,146,160,88,85,173,160,0.491329479768786,0.534246575342466,0.489028213166144,-0.0429170955736797
"Chr01","79096706","A","T",75,67,142,137,98,86,184,137,0.467391304347826,0.471830985915493,0.530674846625767,-0.00443968156766683
"Chr01","79096768","C","T",72,71,143,139,107,107,214,139,0.5,0.496503496503497,0.50140056022409,0.00349650349650349
"Chr01","79097115","C","T",72,72,144,160,113,109,222,160,0.490990990990991,0.5,0.505464480874317,-0.00900900900900903
"Chr01","79101494","G","A",50,53,103,146,48,42,90,146,0.466666666666667,0.514563106796116,0.507772020725389,-0.0478964401294498
"Chr01","79102504","T","C",87,81,168,160,84,97,181,160,0.535911602209945,0.482142857142857,0.489971346704871,0.0537687450670876
"Chr01","79102565","C","T",79,68,147,160,65,87,152,160,0.572368421052632,0.462585034013605,0.481605351170569,0.109783387039026
"Chr01","79102571","A","G",81,68,149,136,66,85,151,136,0.562913907284768,0.456375838926175,0.49,0.106538068358594
"Chr01","79102581","G","A",74,66,140,138,65,79,144,138,0.548611111111111,0.471428571428571,0.48943661971831,0.0771825396825397
"Chr01","79103031","G","C",37,39,76,148,48,51,99,148,0.515151515151515,0.513157894736842,0.485714285714286,0.00199362041467299
"Chr01","79103135","A","G",34,48,82,152,44,41,85,152,0.482352941176471,0.585365853658537,0.467065868263473,-0.103012912482066
"Chr01","79103266","C","G",24,29,53,160,38,32,70,160,0.457142857142857,0.547169811320755,0.504065040650406,-0.0900269541778976
"Chr01","79103342","C","G",38,37,75,160,40,54,94,160,0.574468085106383,0.493333333333333,0.461538461538462,0.0811347517730497
"Chr01","79103388","G","A",34,33,67,154,53,58,111,154,0.522522522522523,0.492537313432836,0.48876404494382,0.0299852090896867
"Chr01","79103522","G","A",41,57,98,144,47,79,126,144,0.626984126984127,0.581632653061224,0.392857142857143,0.0453514739229025
"Chr01","79103728","G","A",42,42,84,160,67,61,128,160,0.4765625,0.5,0.514150943396226,-0.0234375
"Chr01","79104058","A","G",50,52,102,143,66,70,136,143,0.514705882352941,0.509803921568627,0.487394957983193,0.00490196078431371
"Chr01","79104205","A","G",55,36,91,160,55,49,104,160,0.471153846153846,0.395604395604396,0.564102564102564,0.0755494505494506
"Chr01","79104519","T","C",39,34,73,147,42,53,95,147,0.557894736842105,0.465753424657534,0.482142857142857,0.092141312184571
"Chr01","79104550","C","A",39,44,83,160,42,56,98,160,0.571428571428571,0.530120481927711,0.447513812154696,0.0413080895008605
"Chr01","79104552","C","T",44,38,82,142,56,42,98,142,0.428571428571429,0.463414634146341,0.555555555555556,-0.0348432055749129
"Chr01","79104612","C","T",34,47,81,160,33,52,85,160,0.611764705882353,0.580246913580247,0.403614457831325,0.0315177923021061
"Chr01","79104631","C","T",33,49,82,160,31,46,77,160,0.597402597402597,0.597560975609756,0.40251572327044,-0.000158378207158694
"Chr01","79104675","A","G",49,33,82,148,51,44,95,148,0.463157894736842,0.402439024390244,0.564971751412429,0.0607188703465982
"Chr01","79105143","T","G",35,37,72,160,29,53,82,160,0.646341463414634,0.513888888888889,0.415584415584416,0.132452574525745
"Chr01","79105618","G","T",50,45,95,152,67,64,131,152,0.488549618320611,0.473684210526316,0.517699115044248,0.0148654077942949
"Chr01","79105666","T","C",49,56,105,149,65,65,130,149,0.5,0.533333333333333,0.485106382978723,-0.0333333333333333
"Chr01","79106071","T","C",51,53,104,139,76,68,144,139,0.472222222222222,0.509615384615385,0.512096774193548,-0.0373931623931624
"Chr01","79106149","G","C",56,59,115,160,67,72,139,160,0.517985611510791,0.51304347826087,0.484251968503937,0.00494213324992177
"Chr01","79106184","G","A",51,45,96,160,64,73,137,160,0.532846715328467,0.46875,0.493562231759657,0.0640967153284672
"Chr01","79106537","G","A",68,56,124,160,74,59,133,160,0.443609022556391,0.451612903225806,0.552529182879377,-0.00800388066941549
"Chr01","79106724","C","T",72,84,156,139,66,85,151,139,0.562913907284768,0.538461538461538,0.449511400651466,0.0244523688232298
"Chr01","79106928","G","T",60,61,121,160,76,64,140,160,0.457142857142857,0.504132231404959,0.521072796934866,-0.0469893742621015
"Chr01","79107194","C","T",82,74,156,160,82,105,187,160,0.561497326203209,0.474358974358974,0.478134110787172,0.0871383518442342
"Chr01","79107783","T","A",42,37,79,160,60,46,106,160,0.433962264150943,0.468354430379747,0.551351351351351,-0.0343921662288034
"Chr01","79108128","G","C",32,25,57,160,34,33,67,160,0.492537313432836,0.43859649122807,0.532258064516129,0.0539408222047656
"Chr01","79108272","A","T",46,47,93,146,55,32,87,146,0.367816091954023,0.505376344086022,0.561111111111111,-0.137560252131999
"Chr01","79108294","G","C",38,45,83,160,49,27,76,160,0.355263157894737,0.542168674698795,0.547169811320755,-0.186905516804058
"Chr01","79108311","T","A",35,45,80,147,45,25,70,147,0.357142857142857,0.5625,0.533333333333333,-0.205357142857143
"Chr01","79108452","C","A",112,85,197,141,104,88,192,141,0.458333333333333,0.431472081218274,0.555269922879177,0.0268612521150592
"Chr01","79108465","G","A",123,101,224,135,120,110,230,135,0.478260869565217,0.450892857142857,0.535242290748899,0.0273680124223603
"Chr01","79108505","C","T",99,87,186,160,85,95,180,160,0.527777777777778,0.467741935483871,0.502732240437158,0.0600358422939068
"Chr01","79108515","T","C",79,72,151,138,67,84,151,138,0.556291390728477,0.47682119205298,0.483443708609272,0.0794701986754967
"Chr01","79108524","G","C",70,62,132,160,55,75,130,160,0.576923076923077,0.46969696969697,0.477099236641221,0.107226107226107
"Chr01","79108571","A","T",58,59,117,160,55,72,127,160,0.566929133858268,0.504273504273504,0.463114754098361,0.0626556295847635
"Chr01","79108648","T","A",60,45,105,160,53,49,102,160,0.480392156862745,0.428571428571429,0.545893719806763,0.0518207282913166
"Chr01","79108726","C","T",59,85,144,160,66,74,140,160,0.528571428571429,0.590277777777778,0.440140845070423,-0.0617063492063492
"Chr01","79108816","A","G",69,58,127,160,61,62,123,160,0.504065040650406,0.456692913385827,0.52,0.0473721272645797
"Chr01","79108880","T","A",89,107,196,140,105,90,195,140,0.461538461538462,0.545918367346939,0.49616368286445,-0.0843799058084772
"Chr01","79109151","G","A",70,80,150,136,83,111,194,136,0.572164948453608,0.533333333333333,0.444767441860465,0.0388316151202749
"Chr01","79109159","T","C",65,66,131,136,61,92,153,136,0.601307189542484,0.50381679389313,0.443661971830986,0.0974903956493539
"Chr01","79109200","A","C",46,57,103,139,38,57,95,139,0.6,0.553398058252427,0.424242424242424,0.0466019417475728
"Chr01","79109284","G","A",77,60,137,160,76,61,137,160,0.445255474452555,0.437956204379562,0.558394160583942,0.00729927007299269
"Chr01","79109703","A","G",61,58,119,146,57,81,138,146,0.58695652173913,0.487394957983193,0.459143968871595,0.0995615637559372
"Chr01","79109712","A","G",60,63,123,140,54,86,140,140,0.614285714285714,0.51219512195122,0.433460076045627,0.102090592334495
"Chr01","79109831","C","T",80,65,145,160,104,58,162,160,0.358024691358025,0.448275862068966,0.599348534201954,-0.0902511707109409
"Chr01","79109943","T","C",50,67,117,160,53,107,160,160,0.66875,0.572649572649573,0.371841155234657,0.0961004273504273
"Chr01","79110003","T","C",59,82,141,160,69,96,165,160,0.581818181818182,0.581560283687943,0.418300653594771,0.000257898130238576
"Chr01","79110807","C","T",47,32,79,140,44,69,113,140,0.610619469026549,0.40506329113924,0.473958333333333,0.205556177887308
"Chr01","79110885","A","G",48,23,71,146,41,62,103,146,0.601941747572815,0.323943661971831,0.511494252873563,0.277998085600984
"Chr01","79112029","C","T",19,33,52,142,46,43,89,142,0.48314606741573,0.634615384615385,0.460992907801418,-0.151469317199654
"Chr01","79270811","C","T",11,0,11,0,12,0,12,0,0,0,1,0
"Chr01","79739685","C","T",3,4,7,0,11,11,22,0,0.5,0.571428571428571,0.482758620689655,-0.0714285714285714
"Chr01","79746533","C","T",74,90,164,160,81,150,231,160,0.649350649350649,0.548780487804878,0.392405063291139,0.100570161545771
"Chr01","80040366","A","C",83,83,166,160,83,100,183,160,0.546448087431694,0.5,0.475644699140401,0.046448087431694
"Chr01","80053099","G","A",70,89,159,160,84,111,195,160,0.569230769230769,0.559748427672956,0.435028248587571,0.00948234155781325
"Chr01","80055944","G","A",48,59,107,160,97,55,152,160,0.361842105263158,0.551401869158878,0.55984555984556,-0.189559763895721
"Chr01","80100514","G","A",50,55,105,160,42,60,102,160,0.588235294117647,0.523809523809524,0.444444444444444,0.0644257703081232
"Chr01","80141475","T","C",76,85,161,160,89,73,162,160,0.450617283950617,0.527950310559006,0.510835913312694,-0.0773330266083889
"Chr01","80176938","G","A",43,36,79,155,57,36,93,155,0.387096774193548,0.455696202531646,0.581395348837209,-0.0685994283380972
"Chr01","80210577","A","T",54,68,122,137,65,116,181,137,0.640883977900553,0.557377049180328,0.392739273927393,0.0835069287202247
"Chr01","80229814","C","T",26,10,36,148,25,29,54,148,0.537037037037037,0.277777777777778,0.566666666666667,0.259259259259259
"Chr01","80250635","C","G",73,75,148,140,75,89,164,140,0.542682926829268,0.506756756756757,0.474358974358974,0.0359261700725115
"Chr01","80280150","A","G",71,68,139,137,112,81,193,137,0.419689119170984,0.489208633093525,0.551204819277108,-0.0695195139225407
"Chr01","80292053","C","G",58,55,113,160,38,79,117,160,0.675213675213675,0.486725663716814,0.417391304347826,0.188488011496861
"Chr01","80294292","A","G",36,41,77,142,51,42,93,142,0.451612903225806,0.532467532467532,0.511764705882353,-0.080854629241726
"Chr01","80400636","T","G",53,34,87,160,66,41,107,160,0.383177570093458,0.390804597701149,0.61340206185567,-0.00762702760769152
"Chr01","80477784","T","C",50,50,100,160,38,87,125,160,0.696,0.5,0.391111111111111,0.196
"Chr01","80520872","C","T",20,23,43,160,19,16,35,160,0.457142857142857,0.534883720930233,0.5,-0.0777408637873754
"Chr01","80559115","C","A",73,69,142,138,87,76,163,138,0.466257668711656,0.485915492957746,0.524590163934426,-0.0196578242460901
"Chr01","80616469","T","A",45,40,85,160,43,66,109,160,0.605504587155963,0.470588235294118,0.45360824742268,0.134916351861846
"Chr01","80651386","G","T",43,64,107,160,70,42,112,160,0.375,0.598130841121495,0.515981735159817,-0.223130841121495
"Chr01","80653442","G","A",52,29,81,139,44,39,83,139,0.469879518072289,0.358024691358025,0.585365853658537,0.111854826714264
"Chr01","80688498","T","C",75,54,129,160,63,57,120,160,0.475,0.418604651162791,0.55421686746988,0.0563953488372093
"Chr01","80870422","G","A",54,51,105,160,64,55,119,160,0.46218487394958,0.485714285714286,0.526785714285714,-0.0235294117647059
"Chr02","4250662","A","G",20,16,36,144,26,21,47,144,0.446808510638298,0.444444444444444,0.55421686746988,0.00236406619385343
"Chr02","4307357","G","A",31,36,67,140,32,46,78,140,0.58974358974359,0.537313432835821,0.43448275862069,0.0524301569077689
"Chr02","5825742","G","A",41,37,78,139,35,58,93,139,0.623655913978495,0.474358974358974,0.444444444444444,0.14929693961952
"Chr02","6341491","G","A",6,10,16,43,16,13,29,75,0.448275862068966,0.625,0.488888888888889,-0.176724137931034
"Chr02","6774310","C","T",26,44,70,156,43,49,92,156,0.532608695652174,0.628571428571429,0.425925925925926,-0.0959627329192546
"Chr02","8305054","T","A",64,44,108,160,72,55,127,160,0.433070866141732,0.407407407407407,0.578723404255319,0.0256634587343249
"Chr02","8398052","C","A",3,0,3,14,7,0,7,27,0,0,1,0
"Chr02","9918066","G","C",5,5,10,11,6,3,9,31,0.333333333333333,0.5,0.578947368421053,-0.166666666666667
"Chr02","10419164","A","G",21,20,41,146,32,28,60,146,0.466666666666667,0.48780487804878,0.524752475247525,-0.0211382113821138
"Chr02","10419775","G","A",10,10,20,146,15,17,32,146,0.53125,0.5,0.480769230769231,0.03125
"Chr02","10743476","G","C",7,8,15,75,15,17,32,76,0.53125,0.533333333333333,0.468085106382979,-0.00208333333333333
"Chr02","11420339","T","C",13,10,23,4,11,10,21,60,0.476190476190476,0.434782608695652,0.545454545454545,0.041407867494824
"Chr02","11420345","A","G",15,7,22,0,14,9,23,59,0.391304347826087,0.318181818181818,0.644444444444444,0.0731225296442688
"Chr02","11420351","C","T",17,7,24,51,14,9,23,67,0.391304347826087,0.291666666666667,0.659574468085106,0.0996376811594203
"Chr02","11420361","A","G",7,16,23,0,9,14,23,86,0.608695652173913,0.695652173913043,0.347826086956522,-0.0869565217391304
"Chr02","12613769","C","G",1,2,3,5,7,4,11,0,0.363636363636364,0.666666666666667,0.571428571428571,-0.303030303030303
"Chr02","12769905","T","A",10,22,32,23,27,20,47,0,0.425531914893617,0.6875,0.468354430379747,-0.261968085106383
"Chr02","12972217","G","A",NA,NA,NA,NA,2,2,4,1,0.5,NA,NA,NA
"Chr02","12972236","G","A",NA,NA,NA,NA,2,2,4,1,0.5,NA,NA,NA
"Chr02","12972238","A","T",NA,NA,NA,NA,4,0,4,22,0,NA,NA,NA
"Chr02","12972244","G","T",NA,NA,NA,NA,2,2,4,1,0.5,NA,NA,NA
"Chr02","13118027","G","A",51,34,85,139,40,44,84,139,0.523809523809524,0.4,0.538461538461538,0.123809523809524
"Chr02","13352309","G","C",102,88,190,160,129,80,209,160,0.382775119617225,0.463157894736842,0.578947368421053,-0.0803827751196172
"Chr02","14935852","G","A",50,53,103,160,48,53,101,160,0.524752475247525,0.514563106796116,0.480392156862745,0.0101893684514083
"Chr02","15672880","C","T",11,16,27,147,21,33,54,147,0.611111111111111,0.592592592592593,0.395061728395062,0.0185185185185186
"Chr02","15690708","C","T",4,11,15,78,15,23,38,160,0.605263157894737,0.733333333333333,0.358490566037736,-0.128070175438596
"Chr02","16293727","A","G",9,7,16,4,6,15,21,0,0.714285714285714,0.4375,0.405405405405405,0.276785714285714
"Chr02","16293728","C","A",7,9,16,4,16,6,22,0,0.272727272727273,0.5625,0.605263157894737,-0.289772727272727
"Chr02","16418297","C","G",24,19,43,160,31,35,66,160,0.53030303030303,0.441860465116279,0.504587155963303,0.0884425651867512
"Chr02","16746208","G","A",16,22,38,5,29,11,40,88,0.275,0.578947368421053,0.576923076923077,-0.303947368421053
"Chr02","16812220","G","A",33,26,59,140,27,40,67,134,0.597014925373134,0.440677966101695,0.476190476190476,0.156336959271439
"Chr02","16812252","C","T",25,36,61,139,45,22,67,139,0.328358208955224,0.590163934426229,0.546875,-0.261805725471006
"Chr02","17820205","T","G",13,19,32,0,23,28,51,82,0.549019607843137,0.59375,0.433734939759036,-0.0447303921568627
"Chr02","18839715","G","A",46,38,84,139,41,45,86,105,0.523255813953488,0.452380952380952,0.511764705882353,0.070874861572536
"Chr02","18839728","A","T",46,43,89,160,41,57,98,35,0.581632653061224,0.48314606741573,0.46524064171123,0.0984865856454941
"Chr02","18841561","T","C",55,66,121,160,65,65,130,160,0.5,0.545454545454545,0.47808764940239,-0.0454545454545454
"Chr02","19293810","T","C",80,78,158,136,91,91,182,136,0.5,0.493670886075949,0.502941176470588,0.00632911392405061
"Chr02","19630736","T","A",20,26,46,160,15,27,42,160,0.642857142857143,0.565217391304348,0.397727272727273,0.0776397515527951
"Chr02","20441010","G","A",3,1,4,5,4,3,7,17,0.428571428571429,0.25,0.636363636363636,0.178571428571429
"Chr02","21455322","C","T",15,2,17,29,5,0,5,24,0,0.117647058823529,0.909090909090909,-0.117647058823529
"Chr02","22344793","T","G",82,108,190,138,126,74,200,138,0.37,0.568421052631579,0.533333333333333,-0.198421052631579
"Chr02","23453562","T","A",72,66,138,137,103,81,184,137,0.440217391304348,0.478260869565217,0.543478260869565,-0.0380434782608696
"Chr02","24705893","C","T",51,70,121,143,68,79,147,143,0.537414965986395,0.578512396694215,0.444029850746269,-0.0410974307078202
"Chr02","25619994","C","G",58,37,95,146,59,57,116,146,0.491379310344828,0.389473684210526,0.554502369668246,0.101905626134301
"Chr02","27418764","G","A",101,81,182,160,99,94,193,160,0.487046632124352,0.445054945054945,0.533333333333333,0.0419916870694073
"Chr02","28112160","G","A",75,74,149,143,86,94,180,143,0.522222222222222,0.496644295302013,0.48936170212766,0.0255779269202088
"Chr02","31207869","G","A",7,8,15,160,15,19,34,160,0.558823529411765,0.533333333333333,0.448979591836735,0.0254901960784314
"Chr02","31941396","G","A",30,25,55,145,35,24,59,145,0.406779661016949,0.454545454545455,0.570175438596491,-0.0477657935285054
"Chr02","32943903","C","T",18,35,53,160,29,35,64,160,0.546875,0.660377358490566,0.401709401709402,-0.113502358490566
"Chr02","34344187","C","G",39,64,103,160,64,41,105,160,0.39047619047619,0.621359223300971,0.495192307692308,-0.23088303282478
"Chr02","35068217","C","G",49,51,100,160,84,84,168,160,0.5,0.51,0.496268656716418,-0.01
"Chr02","35738436","C","G",60,45,105,160,59,68,127,160,0.535433070866142,0.428571428571429,0.512931034482759,0.106861642294713
"Chr02","35755871","G","T",57,41,98,160,58,66,124,160,0.532258064516129,0.418367346938776,0.518018018018018,0.113890717577353
"Chr02","35755908","C","T",45,45,90,151,41,66,107,151,0.616822429906542,0.5,0.436548223350254,0.116822429906542
"Chr02","36152517","G","T",39,39,78,160,49,47,96,160,0.489583333333333,0.5,0.505747126436782,-0.0104166666666667
"Chr02","36271068","T","A",85,61,146,136,73,80,153,136,0.522875816993464,0.417808219178082,0.528428093645485,0.105067597815382
"Chr02","36299580","T","C",93,63,156,160,95,90,185,160,0.486486486486487,0.403846153846154,0.551319648093842,0.0826403326403327
"Chr02","36945889","G","A",16,16,32,160,26,30,56,160,0.535714285714286,0.5,0.477272727272727,0.0357142857142857
"Chr02","39135698","C","T",30,41,71,143,40,30,70,143,0.428571428571429,0.577464788732394,0.49645390070922,-0.148893360160966
"Chr02","39180139","T","A",45,38,83,160,59,55,114,160,0.482456140350877,0.457831325301205,0.527918781725888,0.0246248150496724
"Chr02","41132567","C","T",78,73,151,160,93,78,171,160,0.456140350877193,0.483443708609272,0.531055900621118,-0.0273033577320786
"Chr02","42681956","T","A",45,31,76,160,50,58,108,160,0.537037037037037,0.407894736842105,0.516304347826087,0.129142300194932
"Chr02","43472021","C","T",43,39,82,160,51,56,107,160,0.523364485981308,0.475609756097561,0.497354497354497,0.0477547298837474
"Chr02","43560226","G","A",16,16,32,146,24,27,51,146,0.529411764705882,0.5,0.481927710843373,0.0294117647058824
"Chr02","45907826","T","C",88,74,162,139,98,85,183,139,0.46448087431694,0.45679012345679,0.539130434782609,0.00769075086014981
"Chr02","47093478","C","T",25,30,55,160,40,35,75,160,0.466666666666667,0.545454545454545,0.5,-0.0787878787878787
"Chr02","49586488","A","G",47,63,110,160,66,57,123,160,0.463414634146341,0.572727272727273,0.484978540772532,-0.109312638580931
"Chr02","51305712","G","A",34,20,54,160,27,29,56,160,0.517857142857143,0.37037037037037,0.554545454545455,0.147486772486773
"Chr02","51307499","C","G",40,27,67,154,24,40,64,16,0.625,0.402985074626866,0.488549618320611,0.222014925373134
"Chr02","51648646","A","T",25,47,72,135,52,35,87,160,0.402298850574713,0.652777777777778,0.484276729559748,-0.250478927203065
"Chr02","52140243","C","T",44,39,83,160,40,43,83,160,0.518072289156627,0.469879518072289,0.506024096385542,0.0481927710843373
"Chr02","52350516","T","A",76,81,157,138,130,86,216,138,0.398148148148148,0.515923566878981,0.552278820375335,-0.117775418730833
"Chr02","52439321","G","A",17,5,22,32,13,17,30,154,0.566666666666667,0.227272727272727,0.576923076923077,0.339393939393939
"Chr02","52742128","C","A",65,57,122,160,70,73,143,160,0.510489510489511,0.467213114754098,0.509433962264151,0.0432763957354121
"Chr02","52933400","G","C",34,35,69,160,51,45,96,160,0.46875,0.507246376811594,0.515151515151515,-0.0384963768115942
"Chr02","54141884","A","C",72,53,125,151,95,59,154,151,0.383116883116883,0.424,0.598566308243728,-0.0408831168831169
"Chr02","55501098","C","T",31,28,59,139,49,58,107,139,0.542056074766355,0.474576271186441,0.481927710843373,0.0674798035799144
"Chr02","55529014","C","T",29,36,65,160,36,33,69,160,0.478260869565217,0.553846153846154,0.485074626865672,-0.0755852842809365
"Chr02","55752234","T","C",10,18,28,63,10,27,37,12,0.72972972972973,0.642857142857143,0.307692307692308,0.0868725868725868
"Chr02","55813590","T","C",46,37,83,160,59,61,120,160,0.508333333333333,0.44578313253012,0.517241379310345,0.0625502008032128
"Chr02","57105916","A","G",13,14,27,48,24,21,45,69,0.466666666666667,0.518518518518518,0.513888888888889,-0.0518518518518518
"Chr02","58085739","G","T",65,50,115,141,75,69,144,141,0.479166666666667,0.434782608695652,0.540540540540541,0.0443840579710145
"Chr02","58786268","G","A",3,8,11,9,10,2,12,11,0.166666666666667,0.727272727272727,0.565217391304348,-0.560606060606061
"Chr02","59324520","T","C",1,2,3,4,0,3,3,13,1,0.666666666666667,0.166666666666667,0.333333333333333
"Chr02","61604275","T","C",33,58,91,160,47,51,98,160,0.520408163265306,0.637362637362637,0.423280423280423,-0.116954474097331
"Chr02","62295247","C","T",1,6,7,0,6,11,17,58,0.647058823529412,0.857142857142857,0.291666666666667,-0.210084033613445
"Chr02","62295311","G","A",1,6,7,0,6,10,16,0,0.625,0.857142857142857,0.304347826086957,-0.232142857142857
"Chr02","62295318","T","C",7,0,7,0,13,3,16,0,0.1875,0,0.869565217391304,0.1875
"Chr02","63854937","G","A",25,19,44,0,32,21,53,89,0.39622641509434,0.431818181818182,0.587628865979381,-0.0355917667238422
"Chr02","63854971","G","A",24,10,34,3,32,6,38,0,0.157894736842105,0.294117647058824,0.777777777777778,-0.136222910216718
"Chr02","63854983","T","C",21,7,28,2,30,7,37,0,0.189189189189189,0.25,0.784615384615385,-0.0608108108108108
"Chr02","63854996","G","A",4,21,25,0,4,27,31,0,0.870967741935484,0.84,0.142857142857143,0.0309677419354839
"Chr02","63855003","G","A",4,10,14,0,4,24,28,0,0.857142857142857,0.714285714285714,0.19047619047619,0.142857142857143
"Chr02","65778189","C","T",44,41,85,141,43,25,68,141,0.367647058823529,0.482352941176471,0.568627450980392,-0.114705882352941
"Chr02","66609987","G","A",15,22,37,160,27,18,45,160,0.4,0.594594594594595,0.51219512195122,-0.194594594594595
"Chr02","66614097","T","C",73,56,129,160,59,54,113,160,0.47787610619469,0.434108527131783,0.545454545454545,0.0437675790629073
"Chr02","66779927","G","A",6,13,19,7,12,15,27,7,0.555555555555556,0.684210526315789,0.391304347826087,-0.128654970760234
"Chr02","67390659","G","A",47,45,92,146,64,38,102,146,0.372549019607843,0.489130434782609,0.572164948453608,-0.116581415174766
"Chr02","71797667","C","T",35,36,71,160,38,48,86,160,0.558139534883721,0.507042253521127,0.464968152866242,0.0510972813625942
"Chr02","72046488","C","T",35,24,59,144,26,31,57,144,0.543859649122807,0.406779661016949,0.525862068965517,0.137079988105858
"Chr02","74557296","A","T",18,21,39,120,8,33,41,0,0.804878048780488,0.538461538461538,0.325,0.266416510318949
"Chr02","76964180","G","A",38,44,82,139,52,41,93,139,0.440860215053763,0.536585365853659,0.514285714285714,-0.0957251507998951
"Chr03","2947468","G","T",0,2,2,12,NA,NA,NA,NA,NA,1,NA,NA
"Chr03","4478045","A","T",20,31,51,160,21,37,58,160,0.637931034482759,0.607843137254902,0.376146788990826,0.0300878972278568
"Chr03","5098313","T","C",9,20,29,160,6,13,19,83,0.684210526315789,0.689655172413793,0.3125,-0.00544464609800366
"Chr03","7026532","G","C",14,0,14,62,21,3,24,80,0.125,0,0.921052631578947,0.125
"Chr03","7710669","T","C",119,99,218,160,114,114,228,160,0.5,0.454128440366972,0.522421524663677,0.0458715596330275
"Chr03","8488858","C","G",38,23,61,160,31,44,75,160,0.586666666666667,0.377049180327869,0.507352941176471,0.209617486338798
"Chr03","10640989","T","A",29,0,29,122,44,3,47,121,0.0638297872340425,0,0.960526315789474,0.0638297872340425
"Chr03","11784530","G","T",10,0,10,34,6,7,13,50,0.538461538461538,0,0.695652173913043,0.538461538461538
"Chr03","11784603","A","T",10,0,10,38,11,3,14,18,0.214285714285714,0,0.875,0.214285714285714
"Chr03","12818314","C","T",52,98,150,160,95,60,155,160,0.387096774193548,0.653333333333333,0.481967213114754,-0.266236559139785
"Chr03","15465869","C","T",59,66,125,141,48,142,190,141,0.747368421052632,0.528,0.33968253968254,0.219368421052632
"Chr03","16362977","G","A",5,5,10,6,8,3,11,29,0.272727272727273,0.5,0.619047619047619,-0.227272727272727
"Chr03","16362978","G","A",6,6,12,14,4,8,12,38,0.666666666666667,0.5,0.416666666666667,0.166666666666667
"Chr03","17670530","A","G",28,24,52,160,19,39,58,160,0.672413793103448,0.461538461538462,0.427272727272727,0.210875331564987
"Chr03","17907211","A","G",0,11,11,46,6,13,19,1,0.684210526315789,1,0.2,-0.315789473684211
"Chr03","18173873","A","T",51,35,86,160,38,78,116,160,0.672413793103448,0.406976744186047,0.440594059405941,0.265437048917402
"Chr03","18638085","G","A",41,54,95,142,73,32,105,142,0.304761904761905,0.568421052631579,0.57,-0.263659147869674
"Chr03","20154985","G","C",27,36,63,100,40,36,76,140,0.473684210526316,0.571428571428571,0.482014388489209,-0.0977443609022556
"Chr03","22630370","G","A",21,1,22,101,51,0,51,160,0,0.0454545454545455,0.986301369863014,-0.0454545454545455
"Chr03","23110608","A","G",16,13,29,51,14,20,34,29,0.588235294117647,0.448275862068966,0.476190476190476,0.139959432048682
"Chr03","24921496","C","A",10,8,18,146,11,11,22,146,0.5,0.444444444444444,0.525,0.0555555555555556
"Chr03","25085732","G","A",36,36,72,90,39,41,80,160,0.5125,0.5,0.493421052631579,0.0125
"Chr03","25534797","T","C",30,28,58,135,22,44,66,58,0.666666666666667,0.482758620689655,0.419354838709677,0.183908045977011
"Chr03","27582409","T","C",38,33,71,141,38,67,105,141,0.638095238095238,0.464788732394366,0.431818181818182,0.173306505700872
"Chr03","27617599","C","T",18,16,34,144,20,31,51,144,0.607843137254902,0.470588235294118,0.447058823529412,0.137254901960784
"Chr03","28203847","T","C",55,52,107,142,49,85,134,142,0.634328358208955,0.485981308411215,0.431535269709544,0.14834704979774
"Chr03","30747950","G","A",39,35,74,160,15,44,59,160,0.745762711864407,0.472972972972973,0.406015037593985,0.272789738891434
"Chr03","31425741","C","T",71,54,125,143,80,139,219,143,0.634703196347032,0.432,0.438953488372093,0.202703196347032
"Chr03","33793341","T","C",15,5,20,2,21,15,36,140,0.416666666666667,0.25,0.642857142857143,0.166666666666667
"Chr03","34423415","T","A",103,91,194,160,111,93,204,160,0.455882352941176,0.469072164948454,0.537688442211055,-0.0131898120072771
"Chr03","35183493","G","T",34,29,63,160,31,35,66,160,0.53030303030303,0.46031746031746,0.503875968992248,0.06998556998557
"Chr03","40809806","C","T",30,51,81,160,33,62,95,160,0.652631578947368,0.62962962962963,0.357954545454545,0.0230019493177388
"Chr03","40998883","A","T",57,79,136,160,118,61,179,160,0.340782122905028,0.580882352941177,0.555555555555556,-0.240100230036149
"Chr03","41204248","A","G",27,28,55,160,27,26,53,138,0.490566037735849,0.509090909090909,0.5,-0.01852487135506
"Chr03","41674763","C","A",58,46,104,142,90,56,146,142,0.383561643835616,0.442307692307692,0.592,-0.0587460484720759
"Chr03","42384141","C","T",59,40,99,160,33,64,97,160,0.65979381443299,0.404040404040404,0.469387755102041,0.255753410392586
"Chr03","42502488","A","G",34,43,77,139,43,91,134,139,0.67910447761194,0.558441558441558,0.364928909952607,0.120662919170382
"Chr03","43849662","T","G",32,34,66,146,36,29,65,146,0.446153846153846,0.515151515151515,0.519083969465649,-0.068997668997669
"Chr03","44430882","C","T",17,21,38,160,15,22,37,160,0.594594594594595,0.552631578947368,0.426666666666667,0.0419630156472262
"Chr03","46600711","C","T",102,121,223,136,61,162,223,136,0.726457399103139,0.542600896860987,0.365470852017937,0.183856502242152
"Chr03","46991120","A","G",16,8,24,122,19,16,35,143,0.457142857142857,0.333333333333333,0.593220338983051,0.123809523809524
"Chr03","47321006","C","T",23,24,47,135,30,34,64,134,0.53125,0.51063829787234,0.477477477477477,0.0206117021276596
"Chr03","47970123","G","A",23,20,43,38,27,29,56,13,0.517857142857143,0.465116279069767,0.505050505050505,0.0527408637873755
"Chr03","47970139","G","A",20,17,37,45,22,26,48,5,0.541666666666667,0.459459459459459,0.494117647058824,0.0822072072072071
"Chr03","50362670","C","T",14,22,36,144,22,32,54,144,0.592592592592593,0.611111111111111,0.4,-0.0185185185185186
"Chr03","50584563","G","A",19,15,34,160,22,12,34,160,0.352941176470588,0.441176470588235,0.602941176470588,-0.088235294117647
"Chr03","51500168","G","T",27,13,40,69,14,22,36,4,0.611111111111111,0.325,0.539473684210526,0.286111111111111
"Chr03","52223883","C","T",35,35,70,160,43,64,107,160,0.598130841121495,0.5,0.440677966101695,0.0981308411214953
"Chr03","54158244","G","A",53,59,112,160,97,94,191,160,0.492146596858639,0.526785714285714,0.495049504950495,-0.0346391174270755
"Chr03","54456575","G","A",18,14,32,70,20,12,32,84,0.375,0.4375,0.59375,-0.0625
"Chr03","56886540","G","A",25,11,36,0,25,13,38,89,0.342105263157895,0.305555555555556,0.675675675675676,0.0365497076023392
"Chr03","56886545","C","T",13,22,35,0,15,22,37,113,0.594594594594595,0.628571428571429,0.388888888888889,-0.0339768339768339
"Chr03","56886566","A","C",13,15,28,75,16,18,34,82,0.529411764705882,0.535714285714286,0.467741935483871,-0.00630252100840334
"Chr03","56886580","A","T",13,15,28,77,14,17,31,62,0.548387096774194,0.535714285714286,0.457627118644068,0.0126728110599078
"Chr03","56897634","C","T",18,11,29,115,16,28,44,57,0.636363636363636,0.379310344827586,0.465753424657534,0.25705329153605
"Chr03","58561811","G","A",3,5,8,44,4,3,7,3,0.428571428571429,0.625,0.466666666666667,-0.196428571428571
"Chr03","59141148","G","A",0,2,2,5,2,0,2,0,0,1,0.5,-1
"Chr03","59155077","A","G",29,26,55,139,36,33,69,139,0.478260869565217,0.472727272727273,0.524193548387097,0.00553359683794469
"Chr03","60235088","A","C",30,26,56,143,31,36,67,143,0.537313432835821,0.464285714285714,0.495934959349593,0.0730277185501066
"Chr03","62140138","A","G",27,31,58,160,38,42,80,160,0.525,0.53448275862069,0.471014492753623,-0.00948275862068959
"Chr03","64693207","G","A",11,12,23,78,11,12,23,48,0.521739130434783,0.521739130434783,0.478260869565217,0
"Chr03","64693230","G","A",13,5,18,2,6,7,13,72,0.538461538461538,0.277777777777778,0.612903225806452,0.260683760683761
"Chr03","66324614","C","T",82,79,161,136,139,89,228,136,0.390350877192982,0.490683229813665,0.568123393316195,-0.100332352620682
"Chr03","66738661","T","A",102,83,185,136,108,129,237,136,0.544303797468354,0.448648648648649,0.497630331753554,0.0956551488197058
"Chr03","67296778","C","T",93,89,182,160,115,122,237,160,0.514767932489452,0.489010989010989,0.496420047732697,0.0257569434784625
"Chr03","67538171","G","A",76,38,114,142,61,62,123,142,0.504065040650406,0.333333333333333,0.578059071729958,0.170731707317073
"Chr03","67603259","C","T",6,7,13,138,10,6,16,141,0.375,0.538461538461538,0.551724137931034,-0.163461538461538
"Chr03","68067752","G","A",28,36,64,138,47,42,89,138,0.471910112359551,0.5625,0.490196078431373,-0.0905898876404495
"Chr03","68124853","G","A",55,75,130,160,94,57,151,160,0.377483443708609,0.576923076923077,0.530249110320285,-0.199439633214468
"Chr03","68128213","G","A",82,86,168,138,113,92,205,138,0.448780487804878,0.511904761904762,0.522788203753351,-0.0631242740998838
"Chr03","68147594","G","A",46,36,82,160,56,79,135,160,0.585185185185185,0.439024390243902,0.470046082949309,0.146160794941283
"Chr03","68200508","G","C",20,28,48,160,30,24,54,160,0.444444444444444,0.583333333333333,0.490196078431373,-0.138888888888889
"Chr03","68200555","T","C",27,34,61,139,44,41,85,139,0.482352941176471,0.557377049180328,0.486301369863014,-0.0750241080038572
"Chr03","68200676","C","T",51,48,99,138,55,79,134,138,0.58955223880597,0.484848484848485,0.454935622317597,0.104703753957485
"Chr03","68200838","C","G",48,49,97,160,52,58,110,160,0.527272727272727,0.505154639175258,0.483091787439614,0.0221180880974695
"Chr03","68200898","T","G",59,58,117,143,71,73,144,143,0.506944444444444,0.495726495726496,0.498084291187739,0.0112179487179487
"Chr03","68200951","A","C",65,73,138,147,97,69,166,147,0.41566265060241,0.528985507246377,0.532894736842105,-0.113322856643967
"Chr03","68200999","T","A",73,70,143,160,97,67,164,160,0.408536585365854,0.48951048951049,0.553745928338762,-0.0809739041446359
"Chr03","68201011","G","A",81,73,154,160,99,80,179,160,0.446927374301676,0.474025974025974,0.540540540540541,-0.0270985997242981
"Chr03","68201024","A","G",78,85,163,160,103,82,185,160,0.443243243243243,0.521472392638037,0.520114942528736,-0.0782291493947935
"Chr03","68201053","T","G",74,81,155,160,90,70,160,160,0.4375,0.52258064516129,0.520634920634921,-0.0850806451612903
"Chr03","68201065","G","A",74,84,158,136,89,73,162,136,0.450617283950617,0.531645569620253,0.509375,-0.0810282856696358
"Chr03","68201225","G","C",63,58,121,140,104,68,172,140,0.395348837209302,0.479338842975207,0.569965870307167,-0.0839900057659043
"Chr03","68201260","G","A",60,62,122,139,99,58,157,139,0.369426751592357,0.508196721311475,0.56989247311828,-0.138769969719119
"Chr03","68201330","T","C",71,94,165,154,101,78,179,154,0.435754189944134,0.56969696969697,0.5,-0.133942779752836
"Chr03","68201348","A","G",75,94,169,160,100,85,185,160,0.459459459459459,0.556213017751479,0.494350282485876,-0.0967535582920198
"Chr03","68201366","C","T",77,92,169,137,110,84,194,137,0.43298969072165,0.544378698224852,0.515151515151515,-0.111389007503203
"Chr03","68201371","G","T",75,92,167,139,109,86,195,139,0.441025641025641,0.550898203592814,0.50828729281768,-0.109872562567173
"Chr03","68201381","T","C",71,98,169,160,109,88,197,160,0.446700507614213,0.579881656804734,0.491803278688525,-0.13318114919052
"Chr03","68201403","G","C",67,99,166,136,105,99,204,136,0.485294117647059,0.596385542168675,0.464864864864865,-0.111091424521616
"Chr03","68201418","G","A",62,99,161,160,92,104,196,160,0.530612244897959,0.614906832298137,0.431372549019608,-0.0842945874001775
"Chr03","68201483","T","A",90,111,201,160,96,126,222,160,0.567567567567568,0.552238805970149,0.439716312056738,0.0153287615974183
"Chr03","68201502","T","C",84,115,199,160,97,132,229,160,0.576419213973799,0.577889447236181,0.422897196261682,-0.00147023326238171
"Chr03","68201532","A","G",81,102,183,160,87,106,193,160,0.549222797927461,0.557377049180328,0.446808510638298,-0.00815425125286673
"Chr03","68201839","T","G",42,77,119,160,67,67,134,160,0.5,0.647058823529412,0.430830039525692,-0.147058823529412
"Chr03","68201843","C","T",79,42,121,143,69,66,135,143,0.488888888888889,0.347107438016529,0.578125,0.14178145087236
"Chr03","68201854","T","C",48,79,127,136,75,70,145,136,0.482758620689655,0.622047244094488,0.452205882352941,-0.139288623404833
"Chr03","68201914","A","G",96,58,154,138,85,99,184,138,0.53804347826087,0.376623376623377,0.535502958579882,0.161420101637493
"Chr03","68205285","A","G",22,27,49,156,21,32,53,156,0.60377358490566,0.551020408163265,0.42156862745098,0.0527531767423951
"Chr03","68217894","G","A",41,31,72,142,31,62,93,142,0.666666666666667,0.430555555555556,0.436363636363636,0.236111111111111
"Chr03","68235081","G","A",16,14,30,142,8,17,25,142,0.68,0.466666666666667,0.436363636363636,0.213333333333333
"Chr03","68352733","A","C",34,41,75,149,42,33,75,149,0.44,0.546666666666667,0.506666666666667,-0.106666666666667
"Chr03","68407540","C","T",22,24,46,145,24,25,49,145,0.510204081632653,0.521739130434783,0.484210526315789,-0.0115350488021295
"Chr03","68444159","C","T",40,48,88,139,51,40,91,139,0.43956043956044,0.545454545454545,0.508379888268156,-0.105894105894106
"Chr03","68446545","G","A",37,43,80,160,46,51,97,160,0.525773195876289,0.5375,0.468926553672316,-0.0117268041237113
"Chr03","68475323","C","T",74,71,145,136,73,105,178,136,0.589887640449438,0.489655172413793,0.455108359133127,0.100232468035645
"Chr03","68494459","T","C",79,79,158,160,73,70,143,160,0.48951048951049,0.5,0.504983388704319,-0.0104895104895105
"Chr03","68509741","G","A",38,32,70,160,49,55,104,160,0.528846153846154,0.457142857142857,0.5,0.0717032967032967
"Chr03","68594860","G","C",55,59,114,160,84,72,156,160,0.461538461538462,0.517543859649123,0.514814814814815,-0.0560053981106613
"Chr03","68721009","C","A",28,33,61,139,21,55,76,139,0.723684210526316,0.540983606557377,0.357664233576642,0.182700603968939
"Chr03","68726745","C","T",22,18,40,160,32,34,66,160,0.515151515151515,0.45,0.509433962264151,0.0651515151515151
"Chr03","68748893","C","T",46,44,90,147,58,71,129,147,0.550387596899225,0.488888888888889,0.474885844748858,0.0614987080103359
"Chr03","68776898","G","A",17,17,34,160,27,23,50,160,0.46,0.5,0.523809523809524,-0.04
"Chr03","68829335","G","A",9,6,15,125,12,4,16,68,0.25,0.4,0.67741935483871,-0.15
"Chr03","68839886","C","T",41,30,71,143,51,44,95,143,0.463157894736842,0.422535211267606,0.55421686746988,0.0406226834692365
"Chr03","68867754","C","T",42,37,79,139,32,58,90,139,0.644444444444444,0.468354430379747,0.437869822485207,0.176090014064698
"Chr03","68883036","G","A",33,51,84,159,61,41,102,159,0.401960784313726,0.607142857142857,0.505376344086022,-0.205182072829132
"Chr03","68897434","A","T",69,105,174,146,114,93,207,146,0.449275362318841,0.603448275862069,0.480314960629921,-0.154172913543228
"Chr03","68966218","C","T",32,34,66,160,35,50,85,160,0.588235294117647,0.515151515151515,0.443708609271523,0.0730837789661319
"Chr03","68989022","C","G",67,64,131,160,80,94,174,160,0.540229885057471,0.488549618320611,0.481967213114754,0.0516802667368606
"Chr03","69008612","C","T",32,34,66,160,44,35,79,160,0.443037974683544,0.515151515151515,0.524137931034483,-0.0721135404679709
"Chr03","69010170","G","A",19,37,56,143,32,30,62,143,0.483870967741935,0.660714285714286,0.432203389830508,-0.17684331797235
"Chr03","69015930","G","A",7,11,18,142,19,20,39,142,0.512820512820513,0.611111111111111,0.456140350877193,-0.0982905982905984
"Chr03","69020016","A","C",80,83,163,140,102,85,187,140,0.454545454545455,0.50920245398773,0.52,-0.0546569994422755
"Chr03","69027980","G","A",46,43,89,160,42,41,83,160,0.493975903614458,0.48314606741573,0.511627906976744,0.0108298361987275
"Chr03","69040158","G","A",46,81,127,145,62,83,145,145,0.572413793103448,0.637795275590551,0.397058823529412,-0.0653814824871028
"Chr03","69051502","C","T",56,48,104,160,61,69,130,160,0.530769230769231,0.461538461538462,0.5,0.0692307692307692
"Chr03","69051549","T","G",54,43,97,160,57,51,108,160,0.472222222222222,0.443298969072165,0.541463414634146,0.0289232531500573
"Chr03","69063850","T","G",60,78,138,160,68,70,138,160,0.507246376811594,0.565217391304348,0.463768115942029,-0.0579710144927535
"Chr03","69066516","G","A",25,26,51,142,19,24,43,142,0.558139534883721,0.509803921568627,0.468085106382979,0.0483356133150935
"Chr03","69068434","G","T",40,42,82,139,53,43,96,139,0.447916666666667,0.51219512195122,0.52247191011236,-0.0642784552845528
"Chr03","69068844","T","G",29,23,52,153,48,35,83,153,0.421686746987952,0.442307692307692,0.57037037037037,-0.0206209453197405
"Chr03","69074842","G","C",9,14,23,160,12,15,27,160,0.555555555555556,0.608695652173913,0.42,-0.0531400966183575
"Chr03","69168900","G","A",19,18,37,160,19,29,48,160,0.604166666666667,0.486486486486487,0.447058823529412,0.11768018018018
"Chr03","69663282","A","G",44,87,131,137,106,83,189,137,0.439153439153439,0.66412213740458,0.46875,-0.224968698251141
"Chr03","69691021","A","G",92,77,169,160,98,105,203,160,0.517241379310345,0.455621301775148,0.510752688172043,0.0616200775351969
"Chr03","69718704","A","G",43,43,86,155,61,62,123,155,0.504065040650406,0.5,0.497607655502392,0.00406504065040647
"Chr03","69781551","G","A",27,31,58,113,40,34,74,140,0.459459459459459,0.53448275862069,0.507575757575758,-0.0750232991612301
"Chr03","70016929","G","T",22,26,48,160,24,44,68,160,0.647058823529412,0.541666666666667,0.396551724137931,0.105392156862745
"Chr03","70056206","A","G",64,43,107,160,50,71,121,160,0.586776859504132,0.401869158878505,0.5,0.184907700625628
"Chr03","70466407","T","A",13,7,20,138,28,18,46,160,0.391304347826087,0.35,0.621212121212121,0.041304347826087
"Chr03","70481666","T","A",73,78,151,160,73,85,158,160,0.537974683544304,0.516556291390728,0.472491909385113,0.0214183921535753
"Chr03","72196045","C","T",18,24,42,121,25,31,56,6,0.553571428571429,0.571428571428571,0.438775510204082,-0.0178571428571428
"Chr04","92795","G","C",56,38,94,142,48,63,111,142,0.567567567567568,0.404255319148936,0.507317073170732,0.163312248418631
"Chr04","1757999","A","T",35,31,66,160,33,32,65,160,0.492307692307692,0.46969696969697,0.519083969465649,0.0226107226107226
"Chr04","2132794","G","A",41,40,81,160,39,50,89,90,0.561797752808989,0.493827160493827,0.470588235294118,0.0679705923151617
"Chr04","4742185","T","C",41,90,131,160,87,72,159,160,0.452830188679245,0.687022900763359,0.441379310344828,-0.234192712084114
"Chr04","7723742","T","C",24,26,50,160,32,22,54,160,0.407407407407407,0.52,0.538461538461538,-0.112592592592593
"Chr04","9978485","A","T",87,4,91,120,26,105,131,160,0.801526717557252,0.043956043956044,0.509009009009009,0.757570673601208
"Chr04","10606353","G","A",5,8,13,37,9,14,23,1,0.608695652173913,0.615384615384615,0.388888888888889,-0.00668896321070234
"Chr04","11839691","T","C",28,15,43,137,18,35,53,77,0.660377358490566,0.348837209302326,0.479166666666667,0.31154014918824
"Chr04","12566456","A","T",49,38,87,146,50,58,108,113,0.537037037037037,0.436781609195402,0.507692307692308,0.100255427841635
"Chr04","12909813","T","C",75,71,146,160,112,92,204,160,0.450980392156863,0.486301369863014,0.534285714285714,-0.0353209777061509
"Chr04","13243785","G","A",6,4,10,15,4,4,8,2,0.5,0.4,0.555555555555556,0.1
"Chr04","14029211","T","C",12,16,28,110,14,31,45,105,0.688888888888889,0.571428571428571,0.356164383561644,0.117460317460317
"Chr04","15397160","C","T",79,3,82,156,0,77,77,156,1,0.0365853658536585,0.49685534591195,0.963414634146341
"Chr04","18777437","G","A",0,91,91,160,71,0,71,160,0,1,0.438271604938272,-1
"Chr04","19120887","A","G",22,23,45,148,18,24,42,136,0.571428571428571,0.511111111111111,0.459770114942529,0.0603174603174603
"Chr04","19363078","T","A",180,5,185,148,4,230,234,148,0.982905982905983,0.027027027027027,0.439140811455847,0.955878955878956
"Chr04","20860415","A","G",78,94,172,160,82,93,175,160,0.531428571428571,0.546511627906977,0.461095100864553,-0.0150830564784052
"Chr04","21344404","A","T",125,8,133,160,11,159,170,160,0.935294117647059,0.0601503759398496,0.448844884488449,0.875143741707209
"Chr04","22790627","G","A",120,3,123,141,9,153,162,141,0.944444444444444,0.024390243902439,0.452631578947368,0.920054200542005
"Chr04","24179056","A","G",130,2,132,139,27,137,164,21,0.835365853658537,0.0151515151515152,0.530405405405405,0.820214338507021
"Chr04","25049018","G","T",30,32,62,160,26,32,58,160,0.551724137931034,0.516129032258065,0.466666666666667,0.03559510567297
"Chr04","25312090","G","A",9,20,29,135,42,0,42,144,0,0.689655172413793,0.71830985915493,-0.689655172413793
"Chr04","26373885","C","T",29,23,52,140,34,44,78,140,0.564102564102564,0.442307692307692,0.484615384615385,0.121794871794872
"Chr04","27749918","A","G",38,1,39,105,0,59,59,146,1,0.0256410256410256,0.387755102040816,0.974358974358974
"Chr04","28272598","A","G",10,21,31,28,13,25,38,19,0.657894736842105,0.67741935483871,0.333333333333333,-0.0195246179966043
"Chr04","34820642","G","C",117,2,119,160,2,159,161,160,0.987577639751553,0.0168067226890756,0.425,0.970770917062477
"Chr04","36047737","A","G",127,6,133,143,2,143,145,143,0.986206896551724,0.0451127819548872,0.464028776978417,0.941094114596837
"Chr04","36427314","A","T",61,3,64,106,7,76,83,149,0.91566265060241,0.046875,0.462585034013605,0.86878765060241
"Chr04","37798084","C","A",149,2,151,160,0,152,152,160,1,0.0132450331125828,0.491749174917492,0.986754966887417
"Chr04","38542976","C","T",59,0,59,141,0,90,90,158,1,0,0.395973154362416,1
"Chr04","39670563","G","A",53,0,53,137,5,78,83,137,0.939759036144578,0,0.426470588235294,0.939759036144578
"Chr04","39676166","G","A",75,3,78,137,3,113,116,145,0.974137931034483,0.0384615384615385,0.402061855670103,0.935676392572944
"Chr04","41105965","C","T",156,5,161,139,8,190,198,139,0.95959595959596,0.031055900621118,0.456824512534819,0.928540058974842
"Chr04","42024333","A","G",4,10,14,13,10,5,15,6,0.333333333333333,0.714285714285714,0.482758620689655,-0.380952380952381
"Chr04","43147533","C","T",30,18,48,130,69,15,84,0,0.178571428571429,0.375,0.75,-0.196428571428571
"Chr04","43230850","C","A",23,28,51,118,27,28,55,140,0.509090909090909,0.549019607843137,0.471698113207547,-0.0399286987522283
"Chr04","43793470","G","A",97,7,104,101,5,127,132,139,0.962121212121212,0.0673076923076923,0.432203389830508,0.89481351981352
"Chr04","44335130","T","C",60,2,62,144,0,66,66,160,1,0.032258064516129,0.46875,0.967741935483871
"Chr04","45106528","G","A",34,0,34,105,1,56,57,144,0.982456140350877,0,0.384615384615385,0.982456140350877
"Chr04","46793997","C","T",28,39,67,133,33,35,68,160,0.514705882352941,0.582089552238806,0.451851851851852,-0.0673836698858649
"Chr04","48203051","A","G",22,17,39,143,18,19,37,143,0.513513513513513,0.435897435897436,0.526315789473684,0.0776160776160776
"Chr04","48479241","C","T",27,15,42,134,35,26,61,140,0.426229508196721,0.357142857142857,0.601941747572815,0.0690866510538641
"Chr04","48481822","A","G",102,112,214,160,114,143,257,160,0.556420233463035,0.523364485981308,0.45859872611465,0.0330557474817267
"Chr04","48583194","A","G",3,34,37,32,62,0,62,148,0,0.918918918918919,0.656565656565657,-0.918918918918919
"Chr04","48690987","C","T",8,1,9,35,20,5,25,0,0.2,0.111111111111111,0.823529411764706,0.0888888888888889
"Chr04","48691000","C","T",8,1,9,38,20,5,25,11,0.2,0.111111111111111,0.823529411764706,0.0888888888888889
"Chr04","48820651","C","A",38,24,62,114,32,27,59,115,0.457627118644068,0.387096774193548,0.578512396694215,0.0705303444505194
"Chr04","49366139","T","G",23,10,33,44,25,23,48,160,0.479166666666667,0.303030303030303,0.592592592592593,0.176136363636364
"Chr04","49461205","AG","AA",8,17,25,38,16,12,28,11,0.428571428571429,0.68,0.452830188679245,-0.251428571428572
"Chr04","50876250","T","C",41,26,67,57,48,37,85,136,0.435294117647059,0.388059701492537,0.585526315789474,0.0472344161545215
"Chr04","51824813","C","T",10,4,14,11,23,7,30,1,0.233333333333333,0.285714285714286,0.75,-0.0523809523809524
"Chr04","52041382","C","T",18,30,48,137,28,21,49,106,0.428571428571429,0.625,0.474226804123711,-0.196428571428571
"Chr04","53153206","G","A",0,12,12,34,6,17,23,1,0.739130434782609,1,0.171428571428571,-0.260869565217391
"Chr04","58577951","C","T",23,20,43,152,11,12,23,152,0.521739130434783,0.465116279069767,0.515151515151515,0.0566228513650152
"Chr04","58974445","C","T",26,34,60,160,48,39,87,160,0.448275862068966,0.566666666666667,0.503401360544218,-0.118390804597701
"Chr04","60407308","A","G",24,11,35,142,19,36,55,142,0.654545454545455,0.314285714285714,0.477777777777778,0.34025974025974
"Chr04","60655524","G","A",77,73,150,136,144,93,237,136,0.392405063291139,0.486666666666667,0.571059431524548,-0.0942616033755275
"Chr04","61422443","T","C",19,17,36,160,21,26,47,160,0.553191489361702,0.472222222222222,0.481927710843373,0.0809692671394799
"Chr04","61567669","C","T",97,62,159,160,111,86,197,160,0.436548223350254,0.389937106918239,0.584269662921348,0.0466111164320148
"Chr04","62000220","C","T",18,20,38,137,14,10,24,73,0.416666666666667,0.526315789473684,0.516129032258065,-0.109649122807017
"Chr04","62931501","A","G",36,59,95,160,53,44,97,160,0.45360824742268,0.621052631578947,0.463541666666667,-0.167444384156267
"Chr04","63682111","A","G",50,83,133,160,87,63,150,160,0.42,0.62406015037594,0.484098939929329,-0.20406015037594
"Chr04","66852066","G","T",10,0,10,48,10,5,15,74,0.333333333333333,0,0.8,0.333333333333333
"Chr04","67393445","G","C",65,40,105,160,44,67,111,160,0.603603603603604,0.380952380952381,0.50462962962963,0.222651222651223
"Chr05","188554","C","T",63,57,120,141,61,85,146,141,0.582191780821918,0.475,0.466165413533835,0.107191780821918
"Chr05","405154","G","T",58,50,108,141,66,68,134,141,0.507462686567164,0.462962962962963,0.512396694214876,0.0444997236042012
"Chr05","609143","C","A",23,20,43,50,21,18,39,138,0.461538461538462,0.465116279069767,0.536585365853659,-0.00357781753130587
"Chr05","609179","A","G",22,19,41,82,21,17,38,141,0.447368421052632,0.463414634146341,0.544303797468354,-0.0160462130937099
"Chr05","758905","G","A",26,30,56,44,25,29,54,101,0.537037037037037,0.535714285714286,0.463636363636364,0.00132275132275139
"Chr05","758929","T","C",26,24,50,20,27,27,54,110,0.5,0.48,0.509615384615385,0.02
"Chr05","1967937","T","C",13,16,29,9,19,17,36,79,0.472222222222222,0.551724137931034,0.492307692307692,-0.0795019157088123
"Chr05","1967948","T","A",12,16,28,0,22,15,37,49,0.405405405405405,0.571428571428571,0.523076923076923,-0.166023166023166
"Chr05","2719376","G","A",35,38,73,154,33,37,70,154,0.528571428571429,0.520547945205479,0.475524475524476,0.00802348336594916
"Chr05","3186253","G","A",5,10,15,34,3,8,11,21,0.727272727272727,0.666666666666667,0.307692307692308,0.0606060606060607
"Chr05","3186287","G","A",10,5,15,30,8,4,12,18,0.333333333333333,0.333333333333333,0.666666666666667,0
"Chr05","3186290","A","G",5,9,14,32,4,8,12,19,0.666666666666667,0.642857142857143,0.346153846153846,0.0238095238095237
"Chr05","3612713","G","A",25,28,53,160,40,45,85,160,0.529411764705882,0.528301886792453,0.471014492753623,0.00110987791342954
"Chr05","4546570","C","T",12,8,20,18,18,15,33,127,0.454545454545455,0.4,0.566037735849057,0.0545454545454545
"Chr05","5948174","A","G",10,1,11,42,8,6,14,1,0.428571428571429,0.0909090909090909,0.72,0.337662337662338
"Chr05","6791667","G","A",10,15,25,94,18,14,32,136,0.4375,0.6,0.491228070175439,-0.1625
"Chr05","7206518","T","C",19,8,27,84,6,14,20,22,0.7,0.296296296296296,0.531914893617021,0.403703703703704
"Chr05","7285817","C","T",7,14,21,148,7,10,17,141,0.588235294117647,0.666666666666667,0.368421052631579,-0.0784313725490196
"Chr05","7447510","G","A",28,39,67,145,48,33,81,145,0.407407407407407,0.582089552238806,0.513513513513513,-0.174682144831399
"Chr05","7504776","G","A",10,21,31,43,21,29,50,138,0.58,0.67741935483871,0.382716049382716,-0.0974193548387097
"Chr05","7504833","A","C",11,21,32,60,24,26,50,160,0.52,0.65625,0.426829268292683,-0.13625
"Chr05","7569514","T","G",24,26,50,31,17,31,48,25,0.645833333333333,0.52,0.418367346938776,0.125833333333333
"Chr05","8306652","G","C",49,29,78,160,58,59,117,160,0.504273504273504,0.371794871794872,0.548717948717949,0.132478632478632
"Chr05","8321708","T","G",37,48,85,160,65,63,128,160,0.4921875,0.564705882352941,0.47887323943662,-0.0725183823529412
"Chr05","9074096","G","T",18,34,52,135,49,36,85,150,0.423529411764706,0.653846153846154,0.489051094890511,-0.230316742081448
"Chr05","9493069","T","A",8,3,11,29,5,5,10,0,0.5,0.272727272727273,0.619047619047619,0.227272727272727
"Chr05","9493070","A","G",4,7,11,28,9,1,10,32,0.1,0.636363636363636,0.619047619047619,-0.536363636363636
"Chr05","9755453","G","A",42,42,84,146,67,46,113,146,0.407079646017699,0.5,0.553299492385787,-0.0929203539823009
"Chr05","10117080","G","A",63,54,117,160,77,87,164,160,0.530487804878049,0.461538461538462,0.498220640569395,0.0689493433395872
"Chr05","10522861","T","C",49,85,134,160,86,75,161,160,0.46583850931677,0.634328358208955,0.457627118644068,-0.168489848892185
"Chr05","11004095","C","T",71,48,119,143,81,74,155,143,0.47741935483871,0.403361344537815,0.554744525547445,0.0740580103008945
"Chr05","11043525","C","T",55,42,97,138,56,69,125,138,0.552,0.43298969072165,0.5,0.119010309278351
"Chr05","11477726","G","A",10,12,22,160,3,6,9,81,0.666666666666667,0.545454545454545,0.419354838709677,0.121212121212121
"Chr05","11640104","C","G",7,17,24,41,3,8,11,28,0.727272727272727,0.708333333333333,0.285714285714286,0.0189393939393939
"Chr05","11974237","T","G",14,21,35,8,19,11,30,44,0.366666666666667,0.6,0.507692307692308,-0.233333333333333
"Chr05","12181459","C","T",23,10,33,12,20,21,41,93,0.51219512195122,0.303030303030303,0.581081081081081,0.209164818920916
"Chr05","13247803","C","T",5,9,14,42,11,16,27,114,0.592592592592593,0.642857142857143,0.390243902439024,-0.0502645502645503
"Chr05","13465135","T","C",88,95,183,140,102,102,204,140,0.5,0.519125683060109,0.490956072351421,-0.0191256830601093
"Chr05","14587709","G","A",62,65,127,160,70,81,151,160,0.536423841059603,0.511811023622047,0.474820143884892,0.0246128174375554
"Chr05","15305428","A","C",46,54,100,144,72,56,128,144,0.4375,0.54,0.517543859649123,-0.1025
"Chr05","15989170","G","T",62,71,133,160,61,72,133,160,0.541353383458647,0.533834586466165,0.462406015037594,0.00751879699248115
"Chr05","16870896","G","A",102,112,214,138,139,136,275,138,0.494545454545455,0.523364485981308,0.492842535787321,-0.0288190314358538
"Chr05","17153857","A","C",4,5,9,12,5,4,9,9,0.444444444444444,0.555555555555556,0.5,-0.111111111111111
"Chr05","17906657","G","A",23,30,53,142,32,22,54,142,0.407407407407407,0.566037735849057,0.514018691588785,-0.158630328441649
"Chr05","18108561","G","T",59,52,111,160,57,78,135,160,0.577777777777778,0.468468468468468,0.471544715447154,0.109309309309309
"Chr05","18142252","A","G",27,47,74,147,57,35,92,147,0.380434782608696,0.635135135135135,0.506024096385542,-0.254700352526439
"Chr05","18719392","T","C",27,50,77,160,49,45,94,160,0.478723404255319,0.649350649350649,0.444444444444444,-0.17062724509533
"Chr05","19197190","G","T",50,63,113,160,50,50,100,160,0.5,0.557522123893805,0.469483568075117,-0.0575221238938053
"Chr05","19205588","T","C",34,46,80,139,54,49,103,139,0.475728155339806,0.575,0.480874316939891,-0.0992718446601941
"Chr05","19381413","C","T",60,65,125,141,76,105,181,141,0.580110497237569,0.52,0.444444444444444,0.060110497237569
"Chr05","20941774","G","A",51,54,105,146,62,63,125,146,0.504,0.514285714285714,0.491304347826087,-0.0102857142857142
"Chr05","21096762","C","T",44,48,92,143,58,60,118,143,0.508474576271186,0.521739130434783,0.485714285714286,-0.0132645541635962
"Chr05","21592414","A","G",29,32,61,145,32,20,52,145,0.384615384615385,0.524590163934426,0.539823008849557,-0.139974779319042
"Chr05","21658573","C","T",47,43,90,160,62,59,121,160,0.487603305785124,0.477777777777778,0.516587677725118,0.00982552800734615
"Chr05","21672470","G","A",57,65,122,138,59,75,134,138,0.559701492537313,0.532786885245902,0.453125,0.0269146072914117
"Chr05","22992160","C","G",70,67,137,160,58,80,138,160,0.579710144927536,0.489051094890511,0.465454545454545,0.0906590500370253
"Chr05","23988201","C","T",67,61,128,146,72,77,149,146,0.516778523489933,0.4765625,0.501805054151625,0.0402160234899329
"Chr05","24198792","G","A",52,53,105,160,55,68,123,160,0.552845528455285,0.504761904761905,0.469298245614035,0.0480836236933798
"Chr05","24512862","C","T",38,38,76,141,55,49,104,141,0.471153846153846,0.5,0.516666666666667,-0.0288461538461539
"Chr05","24779329","G","A",32,53,85,142,49,53,102,142,0.519607843137255,0.623529411764706,0.433155080213904,-0.103921568627451
"Chr05","24836102","C","T",30,21,51,144,43,29,72,144,0.402777777777778,0.411764705882353,0.59349593495935,-0.00898692810457513
"Chr05","24929956","C","T",43,43,86,160,45,38,83,160,0.457831325301205,0.5,0.520710059171598,-0.0421686746987952
"Chr05","25970092","A","T",51,68,119,140,55,70,125,140,0.56,0.571428571428571,0.434426229508197,-0.0114285714285713
"Chr05","26369083","A","T",80,45,125,142,79,79,158,142,0.5,0.36,0.561837455830389,0.14
"Chr05","26475368","G","A",84,116,200,160,99,90,189,160,0.476190476190476,0.58,0.470437017994859,-0.103809523809524
"Chr05","26672507","T","C",53,54,107,141,53,52,105,141,0.495238095238095,0.504672897196262,0.5,-0.00943480195816637
"Chr05","27187458","C","T",39,55,94,160,55,50,105,160,0.476190476190476,0.585106382978723,0.472361809045226,-0.108915906788247
"Chr05","28451906","T","C",50,41,91,160,86,69,155,160,0.445161290322581,0.450549450549451,0.552845528455285,-0.00538816022686989
"Chr05","28913100","C","G",43,52,95,141,62,50,112,141,0.446428571428571,0.547368421052632,0.507246376811594,-0.10093984962406
"Chr05","28991540","T","A",60,41,101,143,38,37,75,143,0.493333333333333,0.405940594059406,0.556818181818182,0.0873927392739274
"Chr05","29029219","G","A",43,43,86,160,59,57,116,160,0.491379310344828,0.5,0.504950495049505,-0.00862068965517243
"Chr05","29153850","G","A",18,11,29,160,26,29,55,160,0.527272727272727,0.379310344827586,0.523809523809524,0.147962382445141
"Chr05","29533195","A","T",69,69,138,160,97,74,171,160,0.432748538011696,0.5,0.537216828478964,-0.0672514619883041
"Chr05","29651012","G","A",57,60,117,141,78,75,153,141,0.490196078431373,0.512820512820513,0.5,-0.0226244343891402
"Chr05","29848969","G","T",45,36,81,160,49,49,98,160,0.5,0.444444444444444,0.525139664804469,0.0555555555555556
"Chr05","30022247","T","C",80,72,152,142,103,83,186,142,0.446236559139785,0.473684210526316,0.541420118343195,-0.0274476513865308
"Chr05","30045484","C","T",27,33,60,149,28,39,67,149,0.582089552238806,0.55,0.433070866141732,0.0320895522388059
"Chr05","30138824","G","A",36,41,77,160,60,53,113,160,0.469026548672566,0.532467532467532,0.505263157894737,-0.063440983794966
"Chr05","30161503","C","T",27,27,54,142,31,22,53,142,0.415094339622642,0.5,0.542056074766355,-0.0849056603773585
"Chr05","30658887","G","T",64,57,121,150,52,84,136,150,0.617647058823529,0.471074380165289,0.45136186770428,0.14657267865824
"Chr05","30792063","T","G",76,60,136,142,99,67,166,142,0.403614457831325,0.441176470588235,0.579470198675497,-0.03756201275691
"Chr05","31236170","A","T",66,81,147,160,85,112,197,160,0.568527918781726,0.551020408163265,0.438953488372093,0.0175075106184607
"Chr05","31277303","A","G",43,31,74,160,53,43,96,160,0.447916666666667,0.418918918918919,0.564705882352941,0.0289977477477478
"Chr05","31313645","A","G",82,74,156,160,113,90,203,160,0.443349753694581,0.474358974358974,0.543175487465181,-0.031009220664393
"Chr05","32166627","C","T",61,57,118,160,104,60,164,160,0.365853658536585,0.483050847457627,0.585106382978723,-0.117197188921042
"Chr05","32184535","A","G",77,89,166,160,94,95,189,160,0.502645502645503,0.536144578313253,0.48169014084507,-0.0334990756677503
"Chr05","32293415","C","T",15,18,33,143,17,20,37,143,0.540540540540541,0.545454545454545,0.457142857142857,-0.00491400491400484
"Chr05","32383948","C","T",47,46,93,160,53,48,101,160,0.475247524752475,0.494623655913978,0.515463917525773,-0.0193761311615033
"Chr05","32389149","C","T",17,25,42,147,12,12,24,147,0.5,0.595238095238095,0.439393939393939,-0.0952380952380952
"Chr05","32954809","C","T",118,71,189,160,99,70,169,160,0.414201183431953,0.375661375661376,0.606145251396648,0.038539807770577
"Chr05","33377063","G","A",64,52,116,151,62,103,165,151,0.624242424242424,0.448275862068966,0.448398576512456,0.175966562173459
"Chr05","33997634","C","T",58,53,111,160,61,71,132,160,0.537878787878788,0.477477477477477,0.489711934156379,0.0604013104013104
"Chr05","34130938","A","G",66,75,141,160,84,81,165,160,0.490909090909091,0.531914893617021,0.490196078431373,-0.0410058027079304
"Chr05","34775523","G","A",39,36,75,160,55,52,107,160,0.485981308411215,0.48,0.516483516483517,0.00598130841121497
"Chr05","35439364","T","C",21,20,41,160,24,28,52,160,0.538461538461538,0.48780487804878,0.483870967741935,0.050656660412758
"Chr05","36914637","A","T",14,17,31,139,22,27,49,134,0.551020408163265,0.548387096774194,0.45,0.00263331138907175
"Chr05","37333759","G","C",24,37,61,160,28,24,52,160,0.461538461538462,0.60655737704918,0.460176991150442,-0.145018915510719
"Chr05","37522815","T","A",39,23,62,160,37,36,73,160,0.493150684931507,0.370967741935484,0.562962962962963,0.122182942996023
"Chr05","37600899","G","A",60,55,115,160,70,69,139,160,0.496402877697842,0.478260869565217,0.511811023622047,0.0181420081326243
"Chr05","38450239","G","T",31,32,63,143,19,40,59,143,0.677966101694915,0.507936507936508,0.409836065573771,0.170029593758407
"Chr05","39886685","A","T",55,45,100,160,76,77,153,160,0.503267973856209,0.45,0.517786561264822,0.0532679738562091
"Chr05","40344315","T","G",39,40,79,160,37,54,91,160,0.593406593406593,0.506329113924051,0.447058823529412,0.0870774794825427
"Chr05","40887876","T","A",66,52,118,160,65,80,145,160,0.551724137931034,0.440677966101695,0.498098859315589,0.11104617182934
"Chr05","41203140","C","T",89,70,159,160,120,72,192,160,0.375,0.440251572327044,0.595441595441595,-0.065251572327044
"Chr05","41745582","C","T",28,30,58,160,38,34,72,160,0.472222222222222,0.517241379310345,0.507692307692308,-0.0450191570881227
"Chr05","42729822","C","T",68,89,157,160,79,67,146,160,0.458904109589041,0.56687898089172,0.485148514851485,-0.107974871302679
"Chr05","46556526","G","A",53,50,103,160,54,72,126,160,0.571428571428571,0.485436893203884,0.467248908296943,0.0859916782246879
"Chr05","47282358","A","T",65,57,122,144,75,72,147,144,0.489795918367347,0.467213114754098,0.520446096654275,0.0225828036132485
"Chr05","47361824","G","T",36,29,65,140,34,28,62,140,0.451612903225806,0.446153846153846,0.551181102362205,0.00545905707196026
"Chr05","47463447","A","T",21,32,53,135,44,28,72,143,0.388888888888889,0.60377358490566,0.52,-0.214884696016771
"Chr05","47574122","A","T",107,106,213,136,114,99,213,136,0.464788732394366,0.497652582159624,0.518779342723005,-0.0328638497652582
"Chr05","48035416","G","A",32,44,76,141,49,58,107,141,0.542056074766355,0.578947368421053,0.442622950819672,-0.0368912936546976
"Chr05","48035435","T","A",29,43,72,139,53,57,110,139,0.518181818181818,0.597222222222222,0.450549450549451,-0.079040404040404
"Chr05","50464385","C","T",67,71,138,150,85,89,174,150,0.511494252873563,0.514492753623188,0.487179487179487,-0.00299850074962515
"Chr05","50911672","C","G",59,58,117,141,57,53,110,141,0.481818181818182,0.495726495726496,0.511013215859031,-0.0139083139083139
"Chr05","51507402","T","C",59,41,100,144,62,64,126,144,0.507936507936508,0.41,0.535398230088496,0.0979365079365079
"Chr05","52574720","G","A",22,20,42,160,25,27,52,160,0.519230769230769,0.476190476190476,0.5,0.0430402930402931
"Chr05","53043502","T","C",12,11,23,160,14,4,18,9,0.222222222222222,0.478260869565217,0.634146341463415,-0.256038647342995
"Chr05","53619988","G","A",21,23,44,144,21,32,53,144,0.60377358490566,0.522727272727273,0.43298969072165,0.0810463121783876
"Chr05","53771676","T","C",49,53,102,143,30,38,68,143,0.558823529411765,0.519607843137255,0.464705882352941,0.0392156862745098
"Chr05","54255340","G","A",48,39,87,160,40,50,90,160,0.555555555555556,0.448275862068966,0.497175141242938,0.10727969348659
"Chr05","54444729","C","T",16,16,32,143,18,20,38,143,0.526315789473684,0.5,0.485714285714286,0.0263157894736842
"Chr05","55577177","C","T",24,26,50,43,35,36,71,117,0.507042253521127,0.52,0.487603305785124,-0.0129577464788733
"Chr05","55578621","C","A",11,27,38,91,22,37,59,39,0.627118644067797,0.710526315789474,0.34020618556701,-0.0834076717216771
"Chr05","55614778","C","T",12,11,23,58,12,12,24,33,0.5,0.478260869565217,0.51063829787234,0.0217391304347826
"Chr05","55614807","C","G",13,17,30,128,14,16,30,120,0.533333333333333,0.566666666666667,0.45,-0.0333333333333333
"Chr05","55692431","A","G",28,33,61,143,35,40,75,143,0.533333333333333,0.540983606557377,0.463235294117647,-0.00765027322404377
"Chr05","56009946","C","G",84,84,168,160,129,107,236,160,0.453389830508475,0.5,0.527227722772277,-0.0466101694915254
"Chr05","56377895","G","A",43,41,84,145,48,38,86,145,0.441860465116279,0.488095238095238,0.535294117647059,-0.046234772978959
"Chr05","58801408","A","G",49,45,94,139,58,55,113,139,0.486725663716814,0.478723404255319,0.516908212560386,0.00800225946149496
"Chr05","59619903","C","T",44,49,93,139,60,54,114,139,0.473684210526316,0.526881720430108,0.502415458937198,-0.0531975099037917
"Chr05","59906420","C","G",11,16,27,82,16,9,25,77,0.36,0.592592592592593,0.519230769230769,-0.232592592592593
"Chr05","59927865","A","G",16,13,29,0,16,30,46,71,0.652173913043478,0.448275862068966,0.426666666666667,0.203898050974513
"Chr05","60394091","A","T",2,3,5,12,8,8,16,63,0.5,0.6,0.476190476190476,-0.1
"Chr05","60394121","G","A",6,6,12,47,9,11,20,119,0.55,0.5,0.46875,0.05
"Chr05","60507458","C","T",17,19,36,143,20,23,43,143,0.534883720930233,0.527777777777778,0.468354430379747,0.00710594315245472
"Chr05","60541453","C","A",47,74,121,141,68,61,129,141,0.472868217054264,0.611570247933884,0.46,-0.138702030879621
"Chr05","61604218","G","A",17,13,30,73,19,14,33,83,0.424242424242424,0.433333333333333,0.571428571428571,-0.00909090909090909
"Chr05","63176223","A","T",32,14,46,160,50,17,67,0,0.253731343283582,0.304347826086957,0.725663716814159,-0.0506164828033744
"Chr05","64073840","A","C",4,2,6,15,12,5,17,44,0.294117647058824,0.333333333333333,0.695652173913043,-0.0392156862745098
"Chr05","65293196","A","G",45,28,73,160,36,31,67,160,0.462686567164179,0.383561643835616,0.578571428571429,0.0791249233285627
"Chr05","65807285","C","T",9,10,19,141,16,12,28,151,0.428571428571429,0.526315789473684,0.531914893617021,-0.0977443609022556
"Chr05","65841795","A","G",82,72,154,160,94,72,166,160,0.433734939759036,0.467532467532468,0.55,-0.0337975277734314
"Chr05","65842415","G","T",15,7,22,139,35,25,60,160,0.416666666666667,0.318181818181818,0.609756097560976,0.0984848484848485
"Chr05","66161995","T","A",47,35,82,160,38,44,82,160,0.536585365853659,0.426829268292683,0.518292682926829,0.109756097560976
"Chr05","66163207","G","A",31,25,56,160,36,38,74,160,0.513513513513513,0.446428571428571,0.515384615384615,0.067084942084942
"Chr05","66814089","C","T",25,11,36,0,29,7,36,129,0.194444444444444,0.305555555555556,0.75,-0.111111111111111
"Chr05","67153273","T","C",6,19,25,66,12,20,32,6,0.625,0.76,0.315789473684211,-0.135
"Chr05","67490127","G","A",55,77,132,160,112,74,186,160,0.397849462365591,0.583333333333333,0.525157232704403,-0.185483870967742
"Chr05","67642749","C","T",29,33,62,118,36,49,85,69,0.576470588235294,0.532258064516129,0.442176870748299,0.0442125237191651
"Chr05","67643275","T","C",7,22,29,0,13,17,30,43,0.566666666666667,0.758620689655172,0.338983050847458,-0.191954022988506
"Chr05","67719720","C","T",30,41,71,160,37,56,93,160,0.602150537634409,0.577464788732394,0.408536585365854,0.0246857489020142
"Chr05","67824835","C","T",2,0,2,8,NA,NA,NA,NA,NA,0,NA,NA
"Chr05","67893388","T","G",63,50,113,140,62,64,126,140,0.507936507936508,0.442477876106195,0.523012552301255,0.0654586318303132
"Chr05","68135323","G","A",7,5,12,21,10,11,21,78,0.523809523809524,0.416666666666667,0.515151515151515,0.107142857142857
"Chr05","68342000","G","A",35,28,63,135,40,34,74,100,0.459459459459459,0.444444444444444,0.547445255474453,0.0150150150150151
"Chr05","69184085","G","A",6,4,10,7,9,3,12,8,0.25,0.4,0.681818181818182,-0.15
"Chr05","70815478","G","A",5,9,14,41,9,16,25,66,0.64,0.642857142857143,0.358974358974359,-0.00285714285714289
"Chr06","210637","C","T",18,15,33,39,23,23,46,121,0.5,0.454545454545455,0.518987341772152,0.0454545454545455
"Chr06","383941","G","A",30,62,92,139,73,48,121,139,0.396694214876033,0.673913043478261,0.483568075117371,-0.277218828602228
"Chr06","384018","A","T",50,53,103,146,86,68,154,146,0.441558441558442,0.514563106796116,0.529182879377432,-0.073004665237675
"Chr06","384024","G","A",52,57,109,140,87,74,161,140,0.459627329192547,0.522935779816514,0.514814814814815,-0.0633084506239672
"Chr06","384059","T","C",57,68,125,160,87,88,175,160,0.502857142857143,0.544,0.48,-0.0411428571428571
"Chr06","384146","A","G",48,61,109,144,89,87,176,144,0.494318181818182,0.559633027522936,0.480701754385965,-0.0653148457047539
"Chr06","384154","C","T",48,59,107,160,92,88,180,160,0.488888888888889,0.551401869158878,0.48780487804878,-0.0625129802699896
"Chr06","384216","T","C",65,75,140,160,103,100,203,160,0.492610837438424,0.535714285714286,0.489795918367347,-0.043103448275862
"Chr06","384222","C","A",61,76,137,160,102,103,205,160,0.502439024390244,0.554744525547445,0.476608187134503,-0.0523055011572013
"Chr06","384235","C","T",63,80,143,143,111,101,212,143,0.476415094339623,0.559440559440559,0.490140845070423,-0.0830254651009368
"Chr06","384273","T","G",69,79,148,160,97,81,178,160,0.455056179775281,0.533783783783784,0.50920245398773,-0.0787276040085029
"Chr06","384599","T","C",77,81,158,160,98,93,191,160,0.486910994764398,0.512658227848101,0.501432664756447,-0.0257472330837033
"Chr06","384784","C","G",79,73,152,160,78,96,174,160,0.551724137931034,0.480263157894737,0.48159509202454,0.0714609800362976
"Chr06","384951","G","A",87,113,200,134,132,146,278,134,0.525179856115108,0.565,0.4581589958159,-0.0398201438848921
"Chr06","385791","G","A",66,83,149,160,83,86,169,160,0.50887573964497,0.557046979865772,0.468553459119497,-0.0481712402208013
"Chr06","387852","A","G",61,106,167,143,73,104,177,143,0.587570621468927,0.634730538922156,0.38953488372093,-0.0471599174532291
"Chr06","388330","G","A",40,51,91,160,52,69,121,160,0.570247933884298,0.56043956043956,0.433962264150943,0.00980837344473706
"Chr06","388697","T","C",80,77,157,139,90,107,197,139,0.543147208121827,0.490445859872611,0.480225988700565,0.0527013482492159
"Chr06","388776","T","C",36,42,78,139,52,58,110,139,0.527272727272727,0.538461538461538,0.468085106382979,-0.0111888111888112
"Chr06","388820","C","A",26,34,60,146,39,39,78,146,0.5,0.566666666666667,0.471014492753623,-0.0666666666666667
"Chr06","389465","C","T",42,44,86,142,67,69,136,142,0.507352941176471,0.511627906976744,0.490990990990991,-0.00427496580027364
"Chr06","390629","C","T",79,110,189,160,114,97,211,160,0.459715639810427,0.582010582010582,0.4825,-0.122294942200155
"Chr06","395933","G","C",70,82,152,140,121,108,229,140,0.471615720524017,0.539473684210526,0.501312335958005,-0.0678579636865089
"Chr06","397058","A","G",61,66,127,139,64,70,134,139,0.522388059701492,0.519685039370079,0.478927203065134,0.00270302033141379
"Chr06","397634","A","C",77,89,166,160,80,70,150,160,0.466666666666667,0.536144578313253,0.496835443037975,-0.0694779116465863
"Chr06","397739","T","A",37,32,69,139,42,37,79,139,0.468354430379747,0.463768115942029,0.533783783783784,0.00458631443771784
"Chr06","397758","A","G",37,46,83,160,47,45,92,160,0.489130434782609,0.55421686746988,0.48,-0.0650864326872708
"Chr06","398591","G","C",21,29,50,143,39,49,88,143,0.556818181818182,0.58,0.434782608695652,-0.0231818181818182
"Chr06","399006","T","C",28,41,69,160,37,53,90,160,0.588888888888889,0.594202898550725,0.408805031446541,-0.00531400966183571
"Chr06","399181","A","G",61,45,106,160,79,72,151,160,0.47682119205298,0.424528301886792,0.544747081712062,0.0522928901661877
"Chr06","399188","G","A",64,50,114,160,81,70,151,160,0.463576158940397,0.43859649122807,0.547169811320755,0.0249796677123272
"Chr06","399193","T","G",63,52,115,160,85,71,156,160,0.455128205128205,0.452173913043478,0.546125461254613,0.00295429208472686
"Chr06","399247","A","G",66,64,130,142,75,68,143,142,0.475524475524476,0.492307692307692,0.516483516483517,-0.0167832167832168
"Chr06","399375","T","C",55,45,100,147,54,62,116,147,0.53448275862069,0.45,0.50462962962963,0.0844827586206896
"Chr06","399528","T","C",40,56,96,147,76,69,145,147,0.475862068965517,0.583333333333333,0.481327800829876,-0.107471264367816
"Chr06","399740","A","G",86,85,171,160,67,76,143,160,0.531468531468531,0.497076023391813,0.487261146496815,0.0343925080767186
"Chr06","400106","G","A",39,27,66,160,60,32,92,160,0.347826086956522,0.409090909090909,0.626582278481013,-0.0612648221343874
"Chr06","400484","A","G",25,27,52,160,34,34,68,160,0.5,0.519230769230769,0.491666666666667,-0.0192307692307693
"Chr06","400527","G","C",24,42,66,160,31,38,69,160,0.550724637681159,0.636363636363636,0.407407407407407,-0.0856389986824769
"Chr06","400557","A","G",24,46,70,140,34,43,77,140,0.558441558441558,0.657142857142857,0.394557823129252,-0.0987012987012987
"Chr06","400818","T","C",34,45,79,139,60,57,117,139,0.487179487179487,0.569620253164557,0.479591836734694,-0.0824407659850698
"Chr06","400942","T","C",52,30,82,160,44,38,82,160,0.463414634146341,0.365853658536585,0.585365853658537,0.0975609756097561
"Chr06","415924","G","A",29,41,70,160,37,51,88,160,0.579545454545455,0.585714285714286,0.417721518987342,-0.00616883116883116
"Chr06","415976","C","A",24,43,67,141,38,41,79,141,0.518987341772152,0.641791044776119,0.424657534246575,-0.122803703003967
"Chr06","416183","A","C",27,44,71,143,64,71,135,143,0.525925925925926,0.619718309859155,0.441747572815534,-0.093792383933229
"Chr06","416252","T","C",28,26,54,139,45,61,106,139,0.575471698113208,0.481481481481481,0.45625,0.0939902166317261
"Chr06","416291","G","A",27,24,51,140,48,63,111,140,0.567567567567568,0.470588235294118,0.462962962962963,0.0969793322734499
"Chr06","416342","G","A",33,27,60,160,48,61,109,160,0.559633027522936,0.45,0.479289940828402,0.109633027522936
"Chr06","416367","T","C",35,27,62,140,47,56,103,140,0.543689320388349,0.435483870967742,0.496969696969697,0.108205449420608
"Chr06","416386","C","T",32,30,62,160,49,51,100,160,0.51,0.483870967741935,0.5,0.0261290322580645
"Chr06","417185","A","G",50,64,114,142,57,59,116,142,0.508620689655172,0.56140350877193,0.465217391304348,-0.0527828191167574
"Chr06","429427","C","A",19,21,40,160,18,14,32,160,0.4375,0.525,0.513888888888889,-0.0875
"Chr06","430154","T","C",40,48,88,143,50,47,97,143,0.484536082474227,0.545454545454545,0.486486486486487,-0.0609184629803186
"Chr06","430165","G","T",41,52,93,160,54,47,101,160,0.465346534653465,0.559139784946237,0.489690721649485,-0.0937932502927711
"Chr06","430550","C","T",49,72,121,139,89,66,155,139,0.425806451612903,0.59504132231405,0.5,-0.169234870701146
"Chr06","430766","G","A",71,77,148,151,106,78,184,151,0.423913043478261,0.52027027027027,0.533132530120482,-0.0963572267920094
"Chr06","432057","C","T",51,75,126,160,60,66,126,160,0.523809523809524,0.595238095238095,0.44047619047619,-0.0714285714285714
"Chr06","432971","G","C",56,74,130,138,58,81,139,138,0.58273381294964,0.569230769230769,0.423791821561338,0.0135030437188711
"Chr06","443393","T","C",27,44,71,141,47,40,87,141,0.459770114942529,0.619718309859155,0.468354430379747,-0.159948194916626
"Chr06","443482","C","T",42,31,73,160,44,35,79,160,0.443037974683544,0.424657534246575,0.565789473684211,0.018380440436969
"Chr06","443685","A","G",24,36,60,160,47,34,81,160,0.419753086419753,0.6,0.50354609929078,-0.180246913580247
"Chr06","443709","T","C",26,34,60,143,47,31,78,143,0.397435897435897,0.566666666666667,0.528985507246377,-0.169230769230769
"Chr06","444130","A","T",33,33,66,160,44,37,81,160,0.45679012345679,0.5,0.523809523809524,-0.0432098765432099
"Chr06","444152","C","G",33,35,68,160,47,37,84,160,0.44047619047619,0.514705882352941,0.526315789473684,-0.0742296918767507
"Chr06","444255","A","C",60,43,103,152,81,59,140,152,0.421428571428571,0.41747572815534,0.580246913580247,0.00395284327323164
"Chr06","444385","G","T",52,54,106,160,63,50,113,160,0.442477876106195,0.509433962264151,0.525114155251142,-0.0669560861579562
"Chr06","444711","G","A",44,64,108,145,67,74,141,145,0.524822695035461,0.592592592592593,0.44578313253012,-0.0677698975571316
"Chr06","445559","A","C",63,58,121,160,66,47,113,160,0.415929203539823,0.479338842975207,0.551282051282051,-0.0634096394353836
"Chr06","445581","A","T",53,68,121,160,68,69,137,160,0.503649635036496,0.56198347107438,0.468992248062016,-0.0583338360378838
"Chr06","445699","G","C",38,66,104,160,64,60,124,160,0.483870967741935,0.634615384615385,0.447368421052632,-0.150744416873449
"Chr06","445916","A","C",70,89,159,145,106,97,203,145,0.477832512315271,0.559748427672956,0.486187845303867,-0.081915915357685
"Chr06","446079","T","C",79,80,159,138,93,91,184,138,0.494565217391304,0.50314465408805,0.501457725947522,-0.00857943669674599
"Chr06","446143","C","T",65,71,136,136,86,71,157,136,0.452229299363057,0.522058823529412,0.515358361774744,-0.0698295241663545
"Chr06","446528","T","A",80,83,163,160,86,97,183,160,0.530054644808743,0.50920245398773,0.479768786127168,0.0208521908210132
"Chr06","447319","G","A",67,81,148,145,111,93,204,145,0.455882352941176,0.547297297297297,0.505681818181818,-0.0914149443561208
"Chr06","448103","G","C",83,69,152,149,80,95,175,149,0.542857142857143,0.453947368421053,0.498470948012232,0.0889097744360902
"Chr06","449200","A","G",61,41,102,142,69,49,118,142,0.415254237288136,0.401960784313726,0.590909090909091,0.0132934529744101
"Chr06","450205","G","T",36,55,91,141,54,76,130,141,0.584615384615385,0.604395604395604,0.407239819004525,-0.0197802197802197
"Chr06","450665","C","T",42,39,81,139,56,61,117,139,0.521367521367521,0.481481481481481,0.494949494949495,0.0398860398860399
"Chr06","450674","A","G",48,43,91,160,55,67,122,160,0.549180327868853,0.472527472527473,0.483568075117371,0.07665285534138
"Chr06","451405","A","G",9,13,22,135,22,25,47,143,0.531914893617021,0.590909090909091,0.449275362318841,-0.0589941972920697
"Chr06","451630","T","C",46,26,72,160,40,35,75,160,0.466666666666667,0.361111111111111,0.585034013605442,0.105555555555556
"Chr06","451692","A","G",39,28,67,140,34,33,67,140,0.492537313432836,0.417910447761194,0.544776119402985,0.0746268656716418
"Chr06","451705","G","A",40,30,70,160,37,31,68,160,0.455882352941176,0.428571428571429,0.557971014492754,0.0273109243697479
"Chr06","452073","G","C",66,42,108,140,56,36,92,140,0.391304347826087,0.388888888888889,0.61,0.00241545893719808
"Chr06","452143","A","G",32,59,91,160,40,55,95,160,0.578947368421053,0.648351648351648,0.387096774193548,-0.0694042799305957
"Chr06","452174","G","A",37,61,98,160,39,50,89,160,0.561797752808989,0.622448979591837,0.406417112299465,-0.060651226782848
"Chr06","453025","C","T",70,42,112,160,52,50,102,160,0.490196078431373,0.375,0.570093457943925,0.115196078431373
"Chr06","453167","C","T",52,52,104,160,39,47,86,160,0.546511627906977,0.5,0.478947368421053,0.0465116279069767
"Chr06","453219","T","A",53,49,102,140,49,58,107,140,0.542056074766355,0.480392156862745,0.488038277511962,0.06166391790361
"Chr06","453964","A","G",58,44,102,148,48,67,115,148,0.582608695652174,0.431372549019608,0.488479262672811,0.151236146632566
"Chr06","454157","C","T",56,46,102,139,62,76,138,139,0.550724637681159,0.450980392156863,0.491666666666667,0.0997442455242967
"Chr06","454370","T","A",45,36,81,160,62,67,129,160,0.51937984496124,0.444444444444444,0.509523809523809,0.0749354005167959
"Chr06","454418","C","T",35,30,65,139,49,69,118,139,0.584745762711864,0.461538461538462,0.459016393442623,0.123207301173403
"Chr06","454467","A","C",27,24,51,160,47,62,109,160,0.568807339449541,0.470588235294118,0.4625,0.0982191041554237
"Chr06","454592","A","G",14,18,32,146,28,40,68,146,0.588235294117647,0.5625,0.42,0.0257352941176471
"Chr06","456717","G","T",76,91,167,160,96,107,203,160,0.527093596059113,0.544910179640719,0.464864864864865,-0.0178165835816052
"Chr06","458312","T","C",101,110,211,160,87,106,193,160,0.549222797927461,0.52132701421801,0.465346534653465,0.0278957837094516
"Chr06","459132","T","G",34,31,65,160,37,46,83,160,0.55421686746988,0.476923076923077,0.47972972972973,0.0772937905468026
"Chr06","459508","T","C",44,22,66,160,40,36,76,160,0.473684210526316,0.333333333333333,0.591549295774648,0.140350877192982
"Chr06","459827","A","C",23,25,48,160,32,30,62,160,0.483870967741935,0.520833333333333,0.5,-0.0369623655913979
"Chr06","460000","G","A",40,29,69,145,34,25,59,145,0.423728813559322,0.420289855072464,0.578125,0.00343895848685827
"Chr06","460037","C","T",41,27,68,160,39,35,74,160,0.472972972972973,0.397058823529412,0.563380281690141,0.0759141494435612
"Chr06","460873","T","C",95,67,162,160,75,77,152,160,0.506578947368421,0.41358024691358,0.54140127388535,0.0929987004548408
"Chr06","464327","A","C",22,9,31,148,9,33,42,136,0.785714285714286,0.290322580645161,0.424657534246575,0.495391705069124
"Chr06","465052","C","A",41,45,86,146,70,33,103,146,0.320388349514563,0.523255813953488,0.587301587301587,-0.202867464438925
"Chr06","465056","A","G",48,28,76,148,45,50,95,148,0.526315789473684,0.368421052631579,0.543859649122807,0.157894736842105
"Chr06","528343","T","A",60,76,136,137,88,87,175,137,0.497142857142857,0.558823529411765,0.47588424437299,-0.0616806722689076
"Chr06","616580","C","T",31,58,89,141,55,60,115,141,0.521739130434783,0.651685393258427,0.42156862745098,-0.129946262823644
"Chr06","617584","G","A",64,68,132,160,111,91,202,160,0.450495049504951,0.515151515151515,0.523952095808383,-0.0646564656465646
"Chr06","617994","A","T",67,62,129,160,90,82,172,160,0.476744186046512,0.48062015503876,0.521594684385382,-0.00387596899224807
"Chr06","639623","G","A",82,81,163,137,102,109,211,137,0.516587677725118,0.496932515337423,0.491978609625668,0.0196551623876952
"Chr06","715406","G","A",46,68,114,142,61,72,133,142,0.541353383458647,0.596491228070175,0.433198380566802,-0.0551378446115288
"Chr06","719151","C","T",103,98,201,160,112,122,234,160,0.521367521367521,0.487562189054726,0.494252873563218,0.033805332312795
"Chr06","720164","C","T",61,67,128,160,64,72,136,160,0.529411764705882,0.5234375,0.473484848484849,0.00597426470588236
"Chr06","750667","C","T",72,81,153,160,111,90,201,160,0.447761194029851,0.529411764705882,0.516949152542373,-0.0816505706760316
"Chr06","759449","C","T",20,32,52,160,26,23,49,160,0.469387755102041,0.615384615384615,0.455445544554455,-0.145996860282575
"Chr06","872963","C","T",85,97,182,160,120,93,213,160,0.436619718309859,0.532967032967033,0.518987341772152,-0.0963473146571738
"Chr06","3070869","T","A",23,32,55,43,18,23,41,90,0.560975609756098,0.581818181818182,0.427083333333333,-0.0208425720620842
"Chr06","3304036","C","T",4,4,8,22,7,7,14,58,0.5,0.5,0.5,0
"Chr06","3786922","T","C",16,9,25,32,8,5,13,18,0.384615384615385,0.36,0.631578947368421,0.0246153846153847
"Chr06","3786993","T","C",11,10,21,83,3,9,12,0,0.75,0.476190476190476,0.424242424242424,0.273809523809524
"Chr06","3913249","A","G",19,46,65,155,30,52,82,155,0.634146341463415,0.707692307692308,0.333333333333333,-0.0735459662288931
"Chr06","4332323","G","C",22,34,56,148,25,28,53,148,0.528301886792453,0.607142857142857,0.431192660550459,-0.0788409703504043
"Chr06","5048094","G","A",71,56,127,139,77,51,128,139,0.3984375,0.440944881889764,0.580392156862745,-0.0425073818897638
"Chr06","5229614","C","A",15,15,30,140,16,24,40,115,0.6,0.5,0.442857142857143,0.1
"Chr06","6333790","C","A",16,12,28,35,20,20,40,62,0.5,0.428571428571429,0.529411764705882,0.0714285714285715
"Chr06","6348367","G","A",15,15,30,117,14,27,41,0,0.658536585365854,0.5,0.408450704225352,0.158536585365854
"Chr06","6854707","C","A",30,25,55,141,17,40,57,141,0.701754385964912,0.454545454545455,0.419642857142857,0.247208931419458
"Chr06","7382021","T","A",8,10,18,5,14,11,25,52,0.44,0.555555555555556,0.511627906976744,-0.115555555555556
"Chr06","7536005","G","C",27,14,41,142,32,22,54,142,0.407407407407407,0.341463414634146,0.621052631578947,0.065943992773261
"Chr06","7619749","A","C",74,87,161,160,94,117,211,160,0.554502369668246,0.540372670807453,0.451612903225806,0.014129698860793
"Chr06","7643776","T","C",48,48,96,160,107,65,172,160,0.377906976744186,0.5,0.578358208955224,-0.122093023255814
"Chr06","8624321","G","A",63,61,124,143,91,72,163,143,0.441717791411043,0.491935483870968,0.536585365853659,-0.0502176924599248
"Chr06","9291285","C","T",44,42,86,140,52,35,87,140,0.402298850574713,0.488372093023256,0.554913294797688,-0.0860732424485431
"Chr06","9445471","A","G",22,22,44,144,22,26,48,144,0.541666666666667,0.5,0.478260869565217,0.0416666666666666
"Chr06","9527857","G","A",67,52,119,160,71,93,164,160,0.567073170731707,0.436974789915966,0.487632508833922,0.130098380815741
"Chr06","10102777","T","C",0,11,11,37,1,6,7,14,0.857142857142857,1,0.0555555555555556,-0.142857142857143
"Chr06","10233595","C","A",0,4,4,14,3,6,9,1,0.666666666666667,1,0.230769230769231,-0.333333333333333
"Chr06","11150584","G","T",46,48,94,139,42,68,110,139,0.618181818181818,0.51063829787234,0.431372549019608,0.107543520309478
"Chr06","11685588","G","A",12,8,20,49,31,11,42,16,0.261904761904762,0.4,0.693548387096774,-0.138095238095238
"Chr06","11685604","T","A",11,10,21,48,25,16,41,75,0.390243902439024,0.476190476190476,0.580645161290323,-0.0859465737514518
"Chr06","11731523","A","C",39,36,75,160,42,46,88,160,0.522727272727273,0.48,0.496932515337423,0.0427272727272727
"Chr06","11967212","A","G",34,23,57,142,67,39,106,142,0.367924528301887,0.403508771929825,0.619631901840491,-0.0355842436279378
"Chr06","12004221","A","G",25,24,49,51,28,32,60,110,0.533333333333333,0.489795918367347,0.486238532110092,0.0435374149659864
"Chr06","12303166","T","C",12,25,37,39,25,39,64,101,0.609375,0.675675675675676,0.366336633663366,-0.0663006756756757
"Chr06","12780001","A","G",14,2,16,60,22,2,24,0,0.0833333333333333,0.125,0.9,-0.0416666666666667
"Chr06","12912237","G","A",34,40,74,140,39,38,77,140,0.493506493506494,0.540540540540541,0.483443708609272,-0.0470340470340471
"Chr06","13011995","C","A",36,40,76,139,53,55,108,139,0.509259259259259,0.526315789473684,0.483695652173913,-0.0170565302144249
"Chr06","13023233","T","G",6,5,11,67,14,3,17,1,0.176470588235294,0.454545454545455,0.714285714285714,-0.27807486631016
"Chr06","13035855","G","T",7,16,23,18,21,11,32,23,0.34375,0.695652173913043,0.509090909090909,-0.351902173913043
"Chr06","13567940","G","A",3,1,4,14,1,0,1,6,0,0.25,0.8,-0.25
"Chr06","14373081","A","C",70,62,132,139,65,76,141,139,0.539007092198582,0.46969696969697,0.494505494505495,0.0693101225016118
"Chr06","14627974","T","C",33,19,52,160,30,49,79,160,0.620253164556962,0.365384615384615,0.480916030534351,0.254868549172347
"Chr06","14735537","G","A",26,21,47,135,29,32,61,160,0.524590163934426,0.446808510638298,0.509259259259259,0.0777816532961284
"Chr06","14769236","C","T",50,50,100,160,43,35,78,160,0.448717948717949,0.5,0.52247191011236,-0.0512820512820513
"Chr06","14786146","C","T",21,25,46,93,20,21,41,145,0.51219512195122,0.543478260869565,0.471264367816092,-0.0312831389183457
"Chr06","14786158","G","A",19,20,39,93,18,20,38,160,0.526315789473684,0.512820512820513,0.480519480519481,0.0134952766531714
"Chr06","15691549","C","T",11,3,14,36,1,5,6,1,0.833333333333333,0.214285714285714,0.6,0.619047619047619
"Chr06","15691592","C","T",10,3,13,34,1,5,6,1,0.833333333333333,0.230769230769231,0.578947368421053,0.602564102564103
"Chr06","15798953","G","A",16,7,23,53,24,16,40,24,0.4,0.304347826086957,0.634920634920635,0.0956521739130435
"Chr06","16083193","C","T",19,21,40,144,22,19,41,144,0.463414634146341,0.525,0.506172839506173,-0.0615853658536585
"Chr06","16310558","A","T",23,23,46,160,18,18,36,160,0.5,0.5,0.5,0
"Chr06","17138457","C","T",25,2,27,103,36,4,40,63,0.1,0.0740740740740741,0.91044776119403,0.0259259259259259
"Chr06","18115902","A","G",17,35,52,110,28,49,77,160,0.636363636363636,0.673076923076923,0.348837209302326,-0.0367132867132868
"Chr06","18118536","A","G",31,34,65,137,31,36,67,137,0.537313432835821,0.523076923076923,0.46969696969697,0.0142365097588978
"Chr06","18399688","G","A",39,30,69,140,27,42,69,140,0.608695652173913,0.434782608695652,0.478260869565217,0.173913043478261
"Chr06","18576989","C","T",43,57,100,160,65,35,100,160,0.35,0.57,0.54,-0.22
"Chr06","18675107","G","T",69,68,137,160,57,93,150,160,0.62,0.496350364963504,0.439024390243902,0.123649635036496
"Chr06","19467263","A","T",8,14,22,45,10,23,33,0,0.696969696969697,0.636363636363636,0.327272727272727,0.0606060606060607
"Chr06","19483450","T","C",3,8,11,5,6,5,11,6,0.454545454545455,0.727272727272727,0.409090909090909,-0.272727272727273
"Chr06","19541604","A","G",8,19,27,38,16,20,36,0,0.555555555555556,0.703703703703704,0.380952380952381,-0.148148148148148
"Chr06","19576902","C","G",10,9,19,46,14,8,22,33,0.363636363636364,0.473684210526316,0.585365853658537,-0.110047846889952
"Chr06","19587425","G","A",15,16,31,160,36,34,70,160,0.485714285714286,0.516129032258065,0.504950495049505,-0.0304147465437788
"Chr06","19592791","A","G",2,10,12,0,0,5,5,4,1,0.833333333333333,0.117647058823529,0.166666666666667
"Chr06","19767952","T","G",33,48,81,160,56,37,93,160,0.397849462365591,0.592592592592593,0.511494252873563,-0.194743130227001
"Chr06","20064719","G","T",38,34,72,142,44,42,86,142,0.488372093023256,0.472222222222222,0.518987341772152,0.0161498708010336
"Chr06","20393545","A","G",76,90,166,136,78,106,184,136,0.576086956521739,0.542168674698795,0.44,0.033918281822944
"Chr06","20425481","A","C",33,30,63,38,27,36,63,86,0.571428571428571,0.476190476190476,0.476190476190476,0.0952380952380952
"Chr06","20666889","G","A",18,27,45,134,48,37,85,160,0.435294117647059,0.6,0.507692307692308,-0.164705882352941
"Chr06","21530892","G","A",34,18,52,160,43,31,74,160,0.418918918918919,0.346153846153846,0.611111111111111,0.0727650727650728
"Chr06","22043951","T","C",69,55,124,160,72,76,148,160,0.513513513513513,0.443548387096774,0.518382352941177,0.0699651264167393
"Chr06","22622874","A","T",16,12,28,22,17,11,28,1,0.392857142857143,0.428571428571429,0.589285714285714,-0.0357142857142857
"Chr06","22648624","G","C",39,37,76,139,38,40,78,139,0.512820512820513,0.486842105263158,0.5,0.0259784075573549
"Chr06","22691665","C","A",41,50,91,160,61,52,113,160,0.460176991150442,0.549450549450549,0.5,-0.089273558300107
"Chr06","22940066","A","T",25,30,55,115,39,32,71,143,0.450704225352113,0.545454545454545,0.507936507936508,-0.0947503201024327
"Chr06","22943886","T","C",69,55,124,136,63,63,126,136,0.5,0.443548387096774,0.528,0.0564516129032258
"Chr06","22982031","C","G",47,53,100,145,57,42,99,145,0.424242424242424,0.53,0.522613065326633,-0.105757575757576
"Chr06","23165108","G","A",1,5,6,18,1,5,6,12,0.833333333333333,0.833333333333333,0.166666666666667,0
"Chr06","23435128","G","A",78,59,137,160,87,78,165,160,0.472727272727273,0.430656934306569,0.54635761589404,0.0420703384207034
"Chr06","24053814","C","T",20,15,35,160,20,17,37,160,0.459459459459459,0.428571428571429,0.555555555555556,0.0308880308880309
"Chr06","24089182","A","C",2,3,5,1,5,6,11,19,0.545454545454545,0.6,0.4375,-0.0545454545454546
"Chr06","24293571","G","A",53,72,125,160,50,73,123,160,0.59349593495935,0.576,0.415322580645161,0.0174959349593496
"Chr06","24336926","C","T",13,18,31,146,20,19,39,146,0.487179487179487,0.580645161290323,0.471428571428571,-0.0934656741108355
"Chr06","24445962","T","A",81,78,159,140,139,87,226,140,0.384955752212389,0.490566037735849,0.571428571428571,-0.10561028552346
"Chr06","24453151","C","T",14,26,40,95,15,22,37,55,0.594594594594595,0.65,0.376623376623377,-0.0554054054054054
"Chr06","24718429","G","T",21,28,49,131,35,30,65,140,0.461538461538462,0.571428571428571,0.491228070175439,-0.10989010989011
"Chr06","24977330","A","G",9,4,13,32,13,11,24,138,0.458333333333333,0.307692307692308,0.594594594594595,0.150641025641026
"Chr06","25167162","C","A",4,12,16,47,3,20,23,54,0.869565217391304,0.75,0.179487179487179,0.119565217391304
"Chr06","25872403","G","T",24,27,51,149,33,35,68,149,0.514705882352941,0.529411764705882,0.478991596638655,-0.0147058823529412
"Chr06","25915598","G","A",3,2,5,4,3,1,4,1,0.25,0.4,0.666666666666667,-0.15
"Chr06","26249209","G","A",23,30,53,140,36,31,67,140,0.462686567164179,0.566037735849057,0.491666666666667,-0.103351168684877
"Chr06","26269909","G","A",13,29,42,147,25,22,47,147,0.468085106382979,0.69047619047619,0.426966292134831,-0.222391084093212
"Chr06","26532704","C","T",36,14,50,142,32,19,51,142,0.372549019607843,0.28,0.673267326732673,0.0925490196078431
"Chr06","26999635","C","T",7,7,14,114,4,9,13,44,0.692307692307692,0.5,0.407407407407407,0.192307692307692
"Chr06","27164820","G","A",6,9,15,33,6,6,12,28,0.5,0.6,0.444444444444444,-0.1
"Chr06","27164835","A","G",9,15,24,16,12,20,32,23,0.625,0.625,0.375,0
"Chr06","27738916","G","A",81,76,157,136,94,70,164,136,0.426829268292683,0.484076433121019,0.545171339563863,-0.0572471648283362
"Chr06","28567090","G","T",43,44,87,140,80,40,120,140,0.333333333333333,0.505747126436782,0.594202898550725,-0.172413793103448
"Chr06","28641092","A","C",36,21,57,160,25,16,41,160,0.390243902439024,0.368421052631579,0.622448979591837,0.0218228498074455
"Chr06","28743640","C","A",97,79,176,160,110,73,183,160,0.398907103825137,0.448863636363636,0.576601671309192,-0.0499565325384997
"Chr06","28876651","G","A",12,10,22,83,15,20,35,145,0.571428571428571,0.454545454545455,0.473684210526316,0.116883116883117
"Chr06","29176336","G","A",32,38,70,160,43,42,85,160,0.494117647058824,0.542857142857143,0.483870967741935,-0.0487394957983193
"Chr06","29323974","C","T",78,101,179,136,93,141,234,136,0.602564102564103,0.564245810055866,0.414043583535109,0.0383182925082366
"Chr06","30011641","A","G",10,6,16,44,15,17,32,0,0.53125,0.375,0.520833333333333,0.15625
"Chr06","30158564","T","A",26,27,53,155,30,27,57,155,0.473684210526316,0.509433962264151,0.509090909090909,-0.0357497517378352
"Chr06","30577979","T","G",32,22,54,160,31,39,70,160,0.557142857142857,0.407407407407407,0.508064516129032,0.14973544973545
"Chr06","32058606","G","A",13,17,30,28,21,32,53,136,0.60377358490566,0.566666666666667,0.409638554216867,0.0371069182389937
"Chr06","32392854","T","C",23,18,41,138,32,37,69,160,0.536231884057971,0.439024390243902,0.5,0.0972074938140686
"Chr06","32583666","T","C",38,42,80,160,67,37,104,160,0.355769230769231,0.525,0.570652173913043,-0.169230769230769
"Chr06","32883058","C","T",24,21,45,138,37,54,91,160,0.593406593406593,0.466666666666667,0.448529411764706,0.126739926739927
"Chr06","32883065","C","T",25,21,46,105,37,57,94,160,0.606382978723404,0.456521739130435,0.442857142857143,0.14986123959297
"Chr06","33699775","A","C",16,5,21,62,15,8,23,102,0.347826086956522,0.238095238095238,0.704545454545455,0.109730848861284
"Chr06","34368555","G","C",29,21,50,143,24,39,63,143,0.619047619047619,0.42,0.469026548672566,0.199047619047619
"Chr06","34435846","A","C",33,41,74,160,42,47,89,160,0.528089887640449,0.554054054054054,0.460122699386503,-0.0259641664136047
"Chr06","34770268","G","A",84,86,170,138,85,134,219,138,0.611872146118721,0.505882352941176,0.434447300771208,0.105989793177545
"Chr06","34967906","T","G",19,22,41,104,24,25,49,131,0.510204081632653,0.536585365853659,0.477777777777778,-0.0263812842210055
"Chr06","35183429","C","T",16,31,47,111,42,29,71,160,0.408450704225352,0.659574468085106,0.491525423728814,-0.251123763859754
"Chr06","35637255","G","A",34,28,62,34,35,38,73,38,0.520547945205479,0.451612903225806,0.511111111111111,0.068935041979673
"Chr06","35937792","G","A",14,16,30,107,21,14,35,1,0.4,0.533333333333333,0.538461538461538,-0.133333333333333
"Chr06","35938849","C","T",24,16,40,137,20,29,49,150,0.591836734693878,0.4,0.49438202247191,0.191836734693878
"Chr06","36284167","G","A",24,28,52,142,27,25,52,142,0.480769230769231,0.538461538461538,0.490384615384615,-0.0576923076923077
"Chr06","36314776","G","A",30,35,65,160,58,50,108,160,0.462962962962963,0.538461538461538,0.508670520231214,-0.0754985754985755
"Chr06","37094897","A","C",23,33,56,143,27,21,48,143,0.4375,0.589285714285714,0.480769230769231,-0.151785714285714
"Chr06","37112919","C","A",19,17,36,79,24,28,52,48,0.538461538461538,0.472222222222222,0.488636363636364,0.0662393162393162
"Chr06","37295968","C","T",50,51,101,160,80,51,131,160,0.389312977099237,0.504950495049505,0.560344827586207,-0.115637517950268
"Chr06","37671173","T","A",9,3,12,29,5,12,17,0,0.705882352941177,0.25,0.482758620689655,0.455882352941177
"Chr06","37671181","G","A",10,4,14,37,3,16,19,0,0.842105263157895,0.285714285714286,0.393939393939394,0.556390977443609
"Chr06","37762356","G","A",10,9,19,67,20,16,36,144,0.444444444444444,0.473684210526316,0.545454545454545,-0.0292397660818713
"Chr06","37942815","C","T",81,87,168,135,77,138,215,135,0.641860465116279,0.517857142857143,0.412532637075718,0.124003322259136
"Chr06","38426715","A","G",41,42,83,145,50,49,99,145,0.494949494949495,0.506024096385542,0.5,-0.0110746014360472
"Chr06","38817764","C","T",6,1,7,32,7,0,7,28,0,0.142857142857143,0.928571428571429,-0.142857142857143
"Chr06","40054764","C","T",58,55,113,140,56,85,141,140,0.602836879432624,0.486725663716814,0.448818897637795,0.11611121571581
"Chr06","40209616","C","G",70,54,124,160,80,104,184,160,0.565217391304348,0.435483870967742,0.487012987012987,0.129733520336606
"Chr06","40276392","C","T",11,14,25,97,14,20,34,128,0.588235294117647,0.56,0.423728813559322,0.028235294117647
"Chr06","40555974","C","A",48,83,131,140,68,53,121,140,0.43801652892562,0.633587786259542,0.46031746031746,-0.195571257333922
"Chr06","40662034","C","G",48,61,109,160,56,63,119,160,0.529411764705882,0.559633027522936,0.456140350877193,-0.0302212628170534
"Chr06","40849716","G","A",23,16,39,142,18,31,49,142,0.63265306122449,0.41025641025641,0.465909090909091,0.22239665096808
"Chr06","43526748","C","T",38,70,108,136,65,79,144,136,0.548611111111111,0.648148148148148,0.408730158730159,-0.099537037037037
"Chr06","43592281","G","A",46,50,96,140,71,80,151,140,0.529801324503311,0.520833333333333,0.473684210526316,0.00896799116997793
"Chr06","43644865","G","A",28,25,53,160,40,18,58,160,0.310344827586207,0.471698113207547,0.612612612612613,-0.16135328562134
"Chr06","44661330","T","G",17,24,41,114,29,22,51,160,0.431372549019608,0.585365853658537,0.5,-0.153993304638929
"Chr06","45528114","G","T",22,20,42,61,15,14,29,73,0.482758620689655,0.476190476190476,0.52112676056338,0.00656814449917903
"Chr06","45869452","G","A",10,6,16,135,17,10,27,142,0.37037037037037,0.375,0.627906976744186,-0.00462962962962965
"Chr06","46627409","A","G",14,10,24,0,18,28,46,0,0.608695652173913,0.416666666666667,0.457142857142857,0.192028985507246
"Chr06","47459538","A","T",15,5,20,83,15,11,26,5,0.423076923076923,0.25,0.652173913043478,0.173076923076923
"Chr06","48589644","A","G",12,14,26,16,23,7,30,68,0.233333333333333,0.538461538461538,0.625,-0.305128205128205
"Chr06","48589674","C","T",12,21,33,2,23,10,33,92,0.303030303030303,0.636363636363636,0.53030303030303,-0.333333333333333
"Chr06","49116964","A","T",79,66,145,160,55,85,140,160,0.607142857142857,0.455172413793103,0.470175438596491,0.151970443349754
"Chr06","50549497","G","C",4,5,9,105,8,6,14,144,0.428571428571429,0.555555555555556,0.521739130434783,-0.126984126984127
"Chr06","51198211","T","A",62,72,134,144,133,86,219,144,0.392694063926941,0.537313432835821,0.552407932011331,-0.14461936890888
"Chr06","51905984","C","T",31,39,70,139,63,41,104,139,0.394230769230769,0.557142857142857,0.540229885057471,-0.162912087912088
"Chr06","52057830","G","C",69,75,144,160,49,102,151,160,0.675496688741722,0.520833333333333,0.4,0.154663355408388
"Chr06","53826128","G","C",9,13,22,160,14,20,34,160,0.588235294117647,0.590909090909091,0.410714285714286,-0.00267379679144386
"Chr06","56029195","G","A",37,57,94,160,82,51,133,160,0.383458646616541,0.606382978723404,0.524229074889868,-0.222924332106863
"Chr06","56340586","T","A",68,84,152,160,72,69,141,160,0.48936170212766,0.552631578947368,0.477815699658703,-0.0632698768197089
"Chr06","56352625","C","T",56,46,102,160,57,72,129,160,0.558139534883721,0.450980392156863,0.489177489177489,0.107159142726858
"Chr06","57064575","A","G",82,59,141,160,81,101,182,160,0.554945054945055,0.418439716312057,0.504643962848297,0.136505338632998
"Chr06","57306300","G","A",39,24,63,160,38,29,67,160,0.432835820895522,0.380952380952381,0.592307692307692,0.0518834399431414
"Chr06","57603147","G","A",18,24,42,109,42,25,67,148,0.373134328358209,0.571428571428571,0.55045871559633,-0.198294243070362
"Chr06","57672134","G","A",14,19,33,80,14,17,31,28,0.548387096774194,0.575757575757576,0.4375,-0.0273704789833823
"Chr06","58791496","T","C",71,83,154,136,70,114,184,136,0.619565217391304,0.538961038961039,0.417159763313609,0.0806041784302653
"Chr06","59695132","G","A",26,51,77,160,36,53,89,160,0.595505617977528,0.662337662337662,0.373493975903614,-0.0668320443601342
"Chr06","60931724","C","T",67,54,121,160,101,81,182,160,0.445054945054945,0.446280991735537,0.554455445544555,-0.00122604668059217
"Chr07","2804901","A","C",58,48,106,160,75,76,151,160,0.503311258278146,0.452830188679245,0.517509727626459,0.0504810695989004
"Chr07","3172916","A","G",69,57,126,160,81,56,137,160,0.408759124087591,0.452380952380952,0.570342205323194,-0.0436218282933611
"Chr07","4043274","C","A",0,9,9,31,4,3,7,4,0.428571428571429,1,0.25,-0.571428571428571
"Chr07","4319910","C","T",27,22,49,160,25,42,67,160,0.626865671641791,0.448979591836735,0.448275862068966,0.177886079805056
"Chr07","5498063","G","A",12,30,42,0,9,24,33,0,0.727272727272727,0.714285714285714,0.28,0.012987012987013
"Chr07","7215155","G","T",14,4,18,25,7,4,11,0,0.363636363636364,0.222222222222222,0.724137931034483,0.141414141414141
"Chr07","7626030","C","T",2,0,2,1,2,8,10,1,0.8,0,0.333333333333333,0.8
"Chr07","7720944","A","G",38,30,68,160,21,38,59,160,0.644067796610169,0.441176470588235,0.464566929133858,0.202891326021934
"Chr07","7965473","AT","AC",21,20,41,102,25,18,43,20,0.418604651162791,0.48780487804878,0.547619047619048,-0.0692002268859898
"Chr07","7965695","T","A",29,34,63,95,22,24,46,0,0.521739130434783,0.53968253968254,0.467889908256881,-0.0179434092477571
"Chr07","8053685","G","A",14,8,22,85,15,14,29,1,0.482758620689655,0.363636363636364,0.568627450980392,0.119122257053292
"Chr07","8053687","G","A",14,5,19,48,20,9,29,94,0.310344827586207,0.263157894736842,0.708333333333333,0.0471869328493648
"Chr07","10219572","A","G",1,8,9,0,1,20,21,66,0.952380952380952,0.888888888888889,0.0666666666666667,0.0634920634920635
"Chr07","10594477","C","T",62,58,120,145,78,71,149,145,0.476510067114094,0.483333333333333,0.520446096654275,-0.0068232662192394
"Chr07","12758694","C","A",54,54,108,140,71,97,168,140,0.577380952380952,0.5,0.452898550724638,0.0773809523809523
"Chr07","13638298","A","C",66,62,128,160,62,75,137,160,0.547445255474453,0.484375,0.483018867924528,0.0630702554744526
"Chr07","13928318","G","A",73,49,122,138,86,69,155,138,0.445161290322581,0.401639344262295,0.574007220216607,0.0435219460602856
"Chr07","13961148","C","T",15,8,23,1,5,3,8,24,0.375,0.347826086956522,0.645161290322581,0.0271739130434783
"Chr07","14757945","C","T",68,46,114,141,65,77,142,141,0.542253521126761,0.403508771929825,0.51953125,0.138744749196936
"Chr07","14905547","G","A",40,36,76,160,82,59,141,160,0.418439716312057,0.473684210526316,0.56221198156682,-0.055244494214259
"Chr07","15412497","C","T",51,57,108,139,53,74,127,139,0.582677165354331,0.527777777777778,0.442553191489362,0.0548993875765529
"Chr07","16632081","G","A",4,4,8,37,9,14,23,0,0.608695652173913,0.5,0.419354838709677,0.108695652173913
"Chr07","16632097","C","G",7,4,11,33,9,14,23,2,0.608695652173913,0.363636363636364,0.470588235294118,0.245059288537549
"Chr07","16674851","G","T",36,32,68,145,30,58,88,145,0.659090909090909,0.470588235294118,0.423076923076923,0.188502673796791
"Chr07","16850016","C","T",3,7,10,40,10,10,20,17,0.5,0.7,0.433333333333333,-0.2
"Chr07","16850024","A","G",3,7,10,42,10,10,20,8,0.5,0.7,0.433333333333333,-0.2
"Chr07","16850031","T","C",7,3,10,39,14,6,20,84,0.3,0.3,0.7,0
"Chr07","16850039","G","A",3,7,10,45,10,10,20,7,0.5,0.7,0.433333333333333,-0.2
"Chr07","19203592","A","G",14,17,31,160,16,19,35,160,0.542857142857143,0.548387096774194,0.454545454545455,-0.00552995391705069
"Chr07","19759944","G","T",85,87,172,160,80,86,166,160,0.518072289156627,0.505813953488372,0.488165680473373,0.0122583356682544
"Chr07","20157754","A","G",16,25,41,78,24,24,48,138,0.5,0.609756097560976,0.449438202247191,-0.109756097560976
"Chr07","21789667","G","T",NA,NA,NA,NA,1,0,1,1,0,NA,NA,NA
"Chr07","21870810","A","G",5,12,17,1,4,15,19,30,0.789473684210526,0.705882352941177,0.25,0.0835913312693498
"Chr07","22372014","G","A",51,41,92,160,71,53,124,160,0.42741935483871,0.445652173913043,0.564814814814815,-0.0182328190743338
"Chr07","22571004","G","A",6,9,15,39,8,13,21,5,0.619047619047619,0.6,0.388888888888889,0.0190476190476191
"Chr07","23406767","G","A",29,42,71,0,41,46,87,29,0.528735632183908,0.591549295774648,0.443037974683544,-0.0628136635907398
"Chr07","23716549","G","T",42,34,76,160,43,48,91,160,0.527472527472527,0.447368421052632,0.508982035928144,0.0801041064198959
"Chr07","24632785","C","T",49,63,112,139,93,50,143,139,0.34965034965035,0.5625,0.556862745098039,-0.21284965034965
"Chr07","24919551","C","A",65,75,140,160,91,73,164,160,0.445121951219512,0.535714285714286,0.513157894736842,-0.0905923344947735
"Chr07","25292639","G","A",38,31,69,144,54,43,97,144,0.443298969072165,0.449275362318841,0.55421686746988,-0.00597639324667565
"Chr07","25716392","A","T",35,38,73,160,76,45,121,160,0.371900826446281,0.520547945205479,0.572164948453608,-0.148647118759198
"Chr07","26093755","TAG","TAT",16,25,41,67,29,27,56,142,0.482142857142857,0.609756097560976,0.463917525773196,-0.127613240418118
"Chr07","26118671","G","A",7,14,21,0,8,13,21,70,0.619047619047619,0.666666666666667,0.357142857142857,-0.0476190476190476
"Chr07","27032766","G","A",61,51,112,160,54,88,142,160,0.619718309859155,0.455357142857143,0.452755905511811,0.164361167002012
"Chr07","28954705","G","A",46,34,80,160,36,73,109,160,0.669724770642202,0.425,0.433862433862434,0.244724770642202
"Chr07","29449110","G","A",56,66,122,141,86,65,151,141,0.43046357615894,0.540983606557377,0.52014652014652,-0.110520030398437
"Chr07","29594851","G","A",30,29,59,0,43,28,71,36,0.394366197183099,0.491525423728814,0.561538461538462,-0.097159226545715
"Chr07","29820130","G","A",16,41,57,140,33,46,79,140,0.582278481012658,0.719298245614035,0.360294117647059,-0.137019764601377
"Chr07","30869912","G","A",17,23,40,92,27,12,39,0,0.307692307692308,0.575,0.556962025316456,-0.267307692307692
"Chr07","30917364","C","A",6,0,6,22,NA,NA,NA,NA,NA,0,NA,NA
"Chr07","30944713","T","C",31,49,80,0,24,27,51,35,0.529411764705882,0.6125,0.419847328244275,-0.0830882352941177
"Chr07","30978608","C","G",31,37,68,160,60,54,114,160,0.473684210526316,0.544117647058823,0.5,-0.0704334365325077
"Chr07","30994361","G","T",74,45,119,160,59,61,120,160,0.508333333333333,0.378151260504202,0.556485355648536,0.130182072829132
"Chr07","31024362","G","A",72,73,145,160,121,59,180,160,0.327777777777778,0.503448275862069,0.593846153846154,-0.175670498084291
"Chr07","31376853","T","A",55,61,116,160,73,31,104,160,0.298076923076923,0.525862068965517,0.581818181818182,-0.227785145888594
"Chr07","31433553","C","T",104,80,184,160,78,157,235,160,0.668085106382979,0.434782608695652,0.43436754176611,0.233302497687327
"Chr07","31655704","G","A",59,83,142,160,94,76,170,160,0.447058823529412,0.584507042253521,0.490384615384615,-0.137448218724109
"Chr07","31697258","G","A",76,70,146,160,86,45,131,160,0.343511450381679,0.479452054794521,0.584837545126354,-0.135940604412841
"Chr07","31881804","A","C",73,68,141,160,91,48,139,160,0.345323741007194,0.482269503546099,0.585714285714286,-0.136945762538905
"Chr07","32444003","G","A",57,57,114,144,92,74,166,144,0.44578313253012,0.5,0.532142857142857,-0.0542168674698795
"Chr07","37163097","T","C",61,57,118,137,58,71,129,137,0.550387596899225,0.483050847457627,0.481781376518219,0.0673367494415977
"Chr07","37828078","C","T",64,60,124,143,78,81,159,143,0.509433962264151,0.483870967741935,0.501766784452297,0.0255629945222154
"Chr07","39288418","G","A",NA,NA,NA,NA,3,1,4,17,0.25,NA,NA,NA
"Chr07","39293954","C","A",52,50,102,160,69,71,140,160,0.507142857142857,0.490196078431373,0.5,0.0169467787114846
"Chr07","39302907","G","T",10,18,28,74,11,18,29,51,0.620689655172414,0.642857142857143,0.368421052631579,-0.0221674876847291
"Chr07","39398634","C","T",15,18,33,0,24,32,56,78,0.571428571428571,0.545454545454545,0.438202247191011,0.025974025974026
"Chr07","41128989","A","G",75,83,158,137,113,78,191,137,0.408376963350785,0.525316455696203,0.538681948424069,-0.116939492345417
"Chr07","41471449","T","G",47,53,100,139,68,42,110,139,0.381818181818182,0.53,0.547619047619048,-0.148181818181818
"Chr07","41480879","G","C",55,55,110,139,101,80,181,139,0.441988950276243,0.5,0.536082474226804,-0.0580110497237569
"Chr07","43385636","G","A",18,5,23,45,19,17,36,78,0.472222222222222,0.217391304347826,0.627118644067797,0.254830917874396
"Chr07","44296277","G","A",64,56,120,147,73,81,154,147,0.525974025974026,0.466666666666667,0.5,0.0593073593073593
"Chr07","44349804","T","C",65,64,129,143,83,67,150,143,0.446666666666667,0.496124031007752,0.530465949820789,-0.0494573643410853
"Chr07","45356794","C","A",76,41,117,160,66,60,126,160,0.476190476190476,0.35042735042735,0.584362139917695,0.125763125763126
"Chr07","47431822","C","A",58,67,125,160,62,72,134,160,0.537313432835821,0.536,0.463320463320463,0.00131343283582086
"Chr07","48507029","G","T",45,52,97,160,69,49,118,160,0.415254237288136,0.536082474226804,0.530232558139535,-0.120828236938669
"Chr07","48560220","T","C",53,61,114,160,94,61,155,160,0.393548387096774,0.535087719298246,0.546468401486989,-0.141539332201471
"Chr07","48759080","C","T",21,24,45,160,36,31,67,160,0.462686567164179,0.533333333333333,0.508928571428571,-0.0706467661691542
"Chr07","48859350","G","C",32,25,57,144,37,54,91,144,0.593406593406593,0.43859649122807,0.466216216216216,0.154810102178523
"Chr07","49342839","A","T",55,75,130,160,99,70,169,160,0.414201183431953,0.576923076923077,0.51505016722408,-0.162721893491124
"Chr07","49836398","G","A",1,5,6,2,8,1,9,35,0.111111111111111,0.833333333333333,0.6,-0.722222222222222
"Chr07","50155362","C","G",96,77,173,136,95,116,211,136,0.549763033175355,0.445086705202312,0.497395833333333,0.104676327973043
"Chr07","51474808","A","T",63,118,181,138,100,84,184,138,0.456521739130435,0.651933701657459,0.446575342465753,-0.195411962527024
"Chr07","52962040","A","C",30,22,52,160,25,31,56,160,0.553571428571429,0.423076923076923,0.509259259259259,0.130494505494506
"Chr07","53059084","C","T",1,1,2,10,3,2,5,23,0.4,0.5,0.571428571428571,-0.1
"Chr07","54426766","G","A",1,6,7,21,2,4,6,5,0.666666666666667,0.857142857142857,0.230769230769231,-0.19047619047619
"Chr07","55127925","T","C",19,6,25,0,13,21,34,138,0.617647058823529,0.24,0.542372881355932,0.377647058823529
"Chr07","56501423","A","G",98,104,202,160,134,93,227,160,0.409691629955947,0.514851485148515,0.540792540792541,-0.105159855192568
"Chr07","56550220","G","A",6,1,7,23,14,3,17,48,0.176470588235294,0.142857142857143,0.833333333333333,0.0336134453781513
"Chr07","57155057","A","C",7,0,7,26,10,2,12,41,0.166666666666667,0,0.894736842105263,0.166666666666667
"Chr07","57720774","G","C",63,71,134,160,68,68,136,160,0.5,0.529850746268657,0.485185185185185,-0.0298507462686567
"Chr07","60036418","C","G",74,79,153,160,64,106,170,160,0.623529411764706,0.516339869281046,0.427244582043344,0.10718954248366
"Chr07","60089598","C","T",0,3,3,18,1,12,13,23,0.923076923076923,1,0.0625,-0.0769230769230769
"Chr07","61130819","A","T",63,61,124,160,80,89,169,160,0.526627218934911,0.491935483870968,0.488054607508532,0.0346917350639435
"Chr07","63864373","T","C",21,28,49,146,26,26,52,146,0.5,0.571428571428571,0.465346534653465,-0.0714285714285714
"Chr07","65476981","C","T",NA,NA,NA,NA,1,0,1,1,0,NA,NA,NA
"Chr08","16608","G","T",83,70,153,160,91,100,191,160,0.523560209424084,0.457516339869281,0.505813953488372,0.0660438695548027
"Chr08","36429","A","G",30,30,60,160,30,30,60,160,0.5,0.5,0.5,0
"Chr08","66919","C","T",77,111,188,137,113,115,228,137,0.504385964912281,0.590425531914894,0.456730769230769,-0.0860395670026129
"Chr08","82282","G","A",20,14,34,143,16,20,36,143,0.555555555555556,0.411764705882353,0.514285714285714,0.143790849673203
"Chr08","85751","G","T",36,75,111,160,67,79,146,160,0.541095890410959,0.675675675675676,0.400778210116732,-0.134579785264717
"Chr08","92130","C","G",36,32,68,140,42,32,74,140,0.432432432432432,0.470588235294118,0.549295774647887,-0.0381558028616852
"Chr08","98766","C","T",60,71,131,142,77,76,153,142,0.496732026143791,0.541984732824427,0.482394366197183,-0.0452527066806366
"Chr08","104566","G","A",49,51,100,160,74,58,132,160,0.439393939393939,0.51,0.530172413793103,-0.0706060606060606
"Chr08","111189","G","A",29,22,51,160,32,43,75,160,0.573333333333333,0.431372549019608,0.484126984126984,0.141960784313725
"Chr08","135214","G","A",33,53,86,142,54,69,123,142,0.560975609756098,0.616279069767442,0.416267942583732,-0.0553034600113442
"Chr08","148075","C","T",79,66,145,136,91,109,200,136,0.545,0.455172413793103,0.492753623188406,0.0898275862068966
"Chr08","191821","C","G",28,69,97,160,53,48,101,160,0.475247524752475,0.711340206185567,0.409090909090909,-0.236092681433092
"Chr08","191924","C","T",43,65,108,160,65,63,128,160,0.4921875,0.601851851851852,0.457627118644068,-0.109664351851852
"Chr08","192191","C","T",50,83,133,160,68,73,141,160,0.517730496453901,0.62406015037594,0.430656934306569,-0.106329653922039
"Chr08","192206","G","A",51,79,130,138,74,77,151,138,0.509933774834437,0.607692307692308,0.444839857651246,-0.0977585328578705
"Chr08","192244","T","C",38,74,112,143,62,73,135,143,0.540740740740741,0.660714285714286,0.404858299595142,-0.119973544973545
"Chr08","192301","T","C",46,83,129,160,75,73,148,160,0.493243243243243,0.643410852713178,0.436823104693141,-0.150167609469935
"Chr08","192397","G","A",51,81,132,142,87,72,159,142,0.452830188679245,0.613636363636364,0.474226804123711,-0.160806174957118
"Chr08","192530","G","T",48,66,114,160,79,54,133,160,0.406015037593985,0.578947368421053,0.51417004048583,-0.172932330827068
"Chr08","193019","T","C",38,45,83,147,67,32,99,147,0.323232323232323,0.542168674698795,0.576923076923077,-0.218936351466472
"Chr08","193027","T","C",34,45,79,149,65,34,99,149,0.343434343434343,0.569620253164557,0.556179775280899,-0.226185909730214
"Chr08","193064","G","C",21,30,51,144,51,21,72,144,0.291666666666667,0.588235294117647,0.585365853658537,-0.29656862745098
"Chr08","193675","T","C",37,40,77,160,55,42,97,160,0.43298969072165,0.519480519480519,0.528735632183908,-0.0864908287588699
"Chr08","194226","C","T",51,71,122,140,52,76,128,140,0.59375,0.581967213114754,0.412,0.0117827868852459
"Chr08","195968","C","A",82,63,145,160,95,100,195,160,0.512820512820513,0.43448275862069,0.520588235294118,0.0783377541998231
"Chr08","196489","C","T",63,154,217,160,104,101,205,160,0.492682926829268,0.709677419354839,0.395734597156398,-0.21699449252557
"Chr08","197538","G","A",31,35,66,160,58,48,106,160,0.452830188679245,0.53030303030303,0.517441860465116,-0.077472841623785
"Chr08","198136","G","A",33,55,88,140,53,42,95,140,0.442105263157895,0.625,0.469945355191257,-0.182894736842105
"Chr08","198599","C","T",72,46,118,160,81,94,175,160,0.537142857142857,0.389830508474576,0.522184300341297,0.147312348668281
"Chr08","198718","T","A",52,61,113,160,82,80,162,160,0.493827160493827,0.539823008849557,0.487272727272727,-0.0459958483557303
"Chr08","199033","A","C",48,25,73,160,40,63,103,160,0.611650485436893,0.342465753424658,0.5,0.269184732012236
"Chr08","199191","C","T",36,31,67,148,30,26,56,148,0.464285714285714,0.462686567164179,0.536585365853659,0.00159914712153519
"Chr08","199197","C","T",35,31,66,160,30,26,56,160,0.464285714285714,0.46969696969697,0.532786885245902,-0.00541125541125542
"Chr08","199209","C","G",32,36,68,144,22,27,49,144,0.551020408163265,0.529411764705882,0.461538461538462,0.0216086434573829
"Chr08","199536","G","A",12,17,29,144,21,16,37,144,0.432432432432432,0.586206896551724,0.5,-0.153774464119292
"Chr08","200664","C","T",53,42,95,147,59,68,127,147,0.535433070866142,0.442105263157895,0.504504504504504,0.0933278077082471
"Chr08","200768","G","A",57,74,131,141,59,89,148,141,0.601351351351351,0.564885496183206,0.415770609318996,0.0364658551681452
"Chr08","201164","G","A",60,80,140,138,86,90,176,138,0.511363636363636,0.571428571428571,0.462025316455696,-0.060064935064935
"Chr08","201749","T","C",47,97,144,145,80,63,143,145,0.440559440559441,0.673611111111111,0.442508710801394,-0.233051670551671
"Chr08","203195","G","A",26,52,78,156,47,40,87,156,0.459770114942529,0.666666666666667,0.442424242424242,-0.206896551724138
"Chr08","203443","G","A",32,63,95,160,55,59,114,160,0.517543859649123,0.663157894736842,0.416267942583732,-0.145614035087719
"Chr08","205255","C","G",66,84,150,160,109,82,191,160,0.429319371727749,0.56,0.513196480938416,-0.130680628272251
"Chr08","205516","A","C",42,45,87,150,43,43,86,150,0.5,0.517241379310345,0.491329479768786,-0.0172413793103449
"Chr08","209484","T","G",19,33,52,159,46,40,86,159,0.465116279069767,0.634615384615385,0.471014492753623,-0.169499105545617
"Chr08","209703","G","A",68,45,113,139,60,60,120,139,0.5,0.398230088495575,0.549356223175966,0.101769911504425
"Chr08","209821","G","T",41,63,104,139,62,38,100,139,0.38,0.605769230769231,0.504901960784314,-0.225769230769231
"Chr08","210412","G","A",54,44,98,139,63,70,133,139,0.526315789473684,0.448979591836735,0.506493506493506,0.0773361976369495
"Chr08","211618","A","G",58,59,117,160,51,57,108,160,0.527777777777778,0.504273504273504,0.484444444444444,0.0235042735042735
"Chr08","211877","C","T",65,63,128,160,54,65,119,160,0.546218487394958,0.4921875,0.481781376518219,0.0540309873949579
"Chr08","211959","G","A",73,68,141,160,65,86,151,160,0.56953642384106,0.482269503546099,0.472602739726027,0.0872669202949604
"Chr08","213384","G","A",29,38,67,143,56,51,107,143,0.476635514018692,0.567164179104478,0.488505747126437,-0.090528665085786
"Chr08","214867","G","A",84,46,130,160,75,103,178,160,0.578651685393258,0.353846153846154,0.516233766233766,0.224805531547105
"Chr08","215060","T","C",49,76,125,143,63,66,129,143,0.511627906976744,0.608,0.440944881889764,-0.0963720930232558
"Chr08","215068","C","T",78,51,129,160,65,63,128,160,0.4921875,0.395348837209302,0.556420233463035,0.0968386627906977
"Chr08","215966","G","A",43,82,125,160,82,82,164,160,0.5,0.656,0.432525951557093,-0.156
"Chr08","217031","G","C",30,54,84,160,42,55,97,160,0.56701030927835,0.642857142857143,0.397790055248619,-0.0758468335787924
"Chr08","217272","A","T",41,65,106,140,62,77,139,140,0.553956834532374,0.613207547169811,0.420408163265306,-0.0592507126374372
"Chr08","218296","G","C",49,77,126,160,77,76,153,160,0.496732026143791,0.611111111111111,0.451612903225806,-0.11437908496732
"Chr08","218594","C","T",100,74,174,160,80,89,169,160,0.526627218934911,0.425287356321839,0.524781341107872,0.101339862613072
"Chr08","218617","T","C",71,109,180,140,91,86,177,140,0.485875706214689,0.605555555555556,0.453781512605042,-0.119679849340866
"Chr08","218686","C","G",98,60,158,160,75,84,159,160,0.528301886792453,0.379746835443038,0.545741324921136,0.148555051349415
"Chr08","218995","G","A",69,75,144,134,59,98,157,134,0.624203821656051,0.520833333333333,0.425249169435216,0.103370488322718
"Chr08","225432","T","C",86,52,138,140,91,82,173,140,0.473988439306358,0.376811594202899,0.569131832797428,0.0971768451034598
"Chr08","228076","G","T",16,9,25,146,7,18,25,118,0.72,0.36,0.46,0.36
"Chr08","228953","G","A",144,74,218,160,113,97,210,160,0.461904761904762,0.339449541284404,0.600467289719626,0.122455220620358
"Chr08","231299","C","T",57,91,148,160,82,79,161,160,0.490683229813665,0.614864864864865,0.449838187702265,-0.1241816350512
"Chr08","232762","C","A",92,63,155,160,100,108,208,160,0.519230769230769,0.406451612903226,0.528925619834711,0.112779156327543
"Chr08","233129","G","T",66,58,124,145,79,56,135,145,0.414814814814815,0.467741935483871,0.55984555984556,-0.0529271206690561
"Chr08","235492","G","A",84,57,141,160,87,86,173,160,0.497109826589595,0.404255319148936,0.544585987261146,0.0928545074406592
"Chr08","235811","C","A",54,27,81,148,40,29,69,148,0.420289855072464,0.333333333333333,0.626666666666667,0.0869565217391304
"Chr08","236585","C","T",50,87,137,152,78,81,159,152,0.509433962264151,0.635036496350365,0.432432432432432,-0.125602534086214
"Chr08","238832","T","C",86,67,153,160,97,80,177,160,0.451977401129944,0.437908496732026,0.554545454545455,0.0140689043979174
"Chr08","239273","G","C",64,84,148,160,102,83,185,160,0.448648648648649,0.567567567567568,0.498498498498498,-0.118918918918919
"Chr08","239544","C","A",135,69,204,160,116,107,223,160,0.479820627802691,0.338235294117647,0.587822014051522,0.141585333685044
"Chr08","241546","A","T",98,62,160,160,105,90,195,160,0.461538461538462,0.3875,0.571830985915493,0.0740384615384616
"Chr08","241782","C","T",42,82,124,160,95,96,191,160,0.50261780104712,0.661290322580645,0.434920634920635,-0.158672521533525
"Chr08","241886","C","T",111,60,171,160,104,124,228,160,0.543859649122807,0.350877192982456,0.538847117794486,0.192982456140351
"Chr08","243342","C","T",32,63,95,144,59,65,124,144,0.524193548387097,0.663157894736842,0.415525114155251,-0.138964346349745
"Chr08","244369","T","A",75,42,117,160,68,68,136,160,0.5,0.358974358974359,0.565217391304348,0.141025641025641
"Chr08","244461","C","G",44,61,105,160,64,62,126,160,0.492063492063492,0.580952380952381,0.467532467532468,-0.088888888888889
"Chr08","245574","G","T",8,12,20,143,2,8,10,36,0.8,0.6,0.333333333333333,0.2
"Chr08","245953","C","G",5,20,25,89,11,2,13,43,0.153846153846154,0.8,0.421052631578947,-0.646153846153846
"Chr08","246051","C","T",7,16,23,142,10,10,20,160,0.5,0.695652173913043,0.395348837209302,-0.195652173913043
"Chr08","246067","C","G",7,16,23,143,12,10,22,160,0.454545454545455,0.695652173913043,0.422222222222222,-0.241106719367589
"Chr08","246240","C","T",12,21,33,160,19,16,35,160,0.457142857142857,0.636363636363636,0.455882352941176,-0.179220779220779
"Chr08","246262","G","A",10,23,33,160,18,23,41,160,0.560975609756098,0.696969696969697,0.378378378378378,-0.135994087213599
"Chr08","246339","G","C",12,23,35,160,10,20,30,160,0.666666666666667,0.657142857142857,0.338461538461538,0.00952380952380949
"Chr08","246355","C","A",10,22,32,160,10,22,32,160,0.6875,0.6875,0.3125,0
"Chr08","246878","C","T",24,55,79,160,41,38,79,160,0.481012658227848,0.69620253164557,0.411392405063291,-0.215189873417722
"Chr08","246956","C","G",39,48,87,140,72,42,114,140,0.368421052631579,0.551724137931034,0.552238805970149,-0.183303085299456
"Chr08","247631","T","C",38,46,84,160,58,50,108,160,0.462962962962963,0.547619047619048,0.5,-0.0846560846560847
"Chr08","248911","C","G",75,70,145,137,92,77,169,137,0.455621301775148,0.482758620689655,0.531847133757962,-0.0271373189145073
"Chr08","249897","A","T",48,26,74,141,55,34,89,141,0.382022471910112,0.351351351351351,0.631901840490798,0.030671120558761
"Chr08","250959","G","T",37,46,83,144,55,52,107,144,0.485981308411215,0.55421686746988,0.484210526315789,-0.0682355590586646
"Chr08","251132","G","A",34,38,72,142,43,53,96,142,0.552083333333333,0.527777777777778,0.458333333333333,0.0243055555555556
"Chr08","251906","A","T",36,52,88,139,61,64,125,139,0.512,0.590909090909091,0.455399061032864,-0.0789090909090909
"Chr08","253110","C","T",33,42,75,141,52,43,95,141,0.452631578947368,0.56,0.5,-0.107368421052632
"Chr08","253837","T","C",30,41,71,140,39,30,69,140,0.434782608695652,0.577464788732394,0.492857142857143,-0.142682180036742
"Chr08","253878","C","T",24,39,63,139,42,40,82,139,0.48780487804878,0.619047619047619,0.455172413793103,-0.131242740998839
"Chr08","255159","C","T",75,50,125,146,81,83,164,146,0.50609756097561,0.4,0.539792387543253,0.10609756097561
"Chr08","255232","G","A",69,66,135,142,71,110,181,142,0.607734806629834,0.488888888888889,0.443037974683544,0.118845917740945
"Chr08","255335","G","A",65,94,159,160,86,87,173,160,0.502890173410405,0.591194968553459,0.454819277108434,-0.0883047951430544
"Chr08","255348","G","A",95,65,160,137,95,94,189,137,0.497354497354497,0.40625,0.544412607449857,0.0911044973544973
"Chr08","255363","C","T",90,55,145,141,85,85,170,141,0.5,0.379310344827586,0.555555555555556,0.120689655172414
"Chr08","255516","C","T",48,65,113,139,81,69,150,139,0.46,0.575221238938053,0.490494296577947,-0.115221238938053
"Chr08","257625","C","T",48,79,127,160,64,72,136,160,0.529411764705882,0.622047244094488,0.425855513307985,-0.0926354793886058
"Chr08","257988","C","A",54,42,96,160,63,77,140,160,0.55,0.4375,0.495762711864407,0.1125
"Chr08","258072","A","G",35,53,88,141,68,58,126,141,0.46031746031746,0.602272727272727,0.481308411214953,-0.141955266955267
"Chr08","258456","C","T",51,79,130,160,85,84,169,160,0.497041420118343,0.607692307692308,0.454849498327759,-0.110650887573964
"Chr08","259032","T","C",82,51,133,160,86,70,156,160,0.448717948717949,0.383458646616541,0.581314878892734,0.0652593021014074
"Chr08","259183","C","T",37,42,79,140,53,47,100,140,0.47,0.531645569620253,0.502793296089385,-0.0616455696202531
"Chr08","259299","C","T",102,80,182,133,102,97,199,133,0.487437185929648,0.43956043956044,0.535433070866142,0.0478767463692087
"Chr08","259473","G","A",35,76,111,160,63,69,132,160,0.522727272727273,0.684684684684685,0.403292181069959,-0.161957411957412
"Chr08","259683","C","G",32,28,60,143,23,43,66,143,0.651515151515151,0.466666666666667,0.436507936507937,0.184848484848485
"Chr08","259707","A","G",35,43,78,141,29,56,85,141,0.658823529411765,0.551282051282051,0.392638036809816,0.107541478129713
"Chr08","259736","C","T",32,40,72,160,31,53,84,160,0.630952380952381,0.555555555555556,0.403846153846154,0.0753968253968254
"Chr08","260019","G","A",42,56,98,160,82,76,158,160,0.481012658227848,0.571428571428571,0.484375,-0.0904159132007233
"Chr08","260578","C","T",33,65,98,160,63,58,121,160,0.479338842975207,0.663265306122449,0.438356164383562,-0.183926463147242
"Chr08","261294","A","C",46,32,78,160,44,43,87,160,0.494252873563218,0.41025641025641,0.545454545454545,0.0839964633068082
"Chr08","261501","T","C",51,54,105,142,77,61,138,142,0.442028985507246,0.514285714285714,0.526748971193416,-0.0722567287784678
"Chr08","262493","C","T",58,42,100,153,76,80,156,153,0.512820512820513,0.42,0.5234375,0.0928205128205128
"Chr08","262647","A","G",54,115,169,160,88,88,176,160,0.5,0.680473372781065,0.411594202898551,-0.180473372781065
"Chr08","263129","A","G",96,71,167,160,97,90,187,160,0.481283422459893,0.425149700598802,0.545197740112994,0.0561337218610906
"Chr08","263310","G","A",55,110,165,138,87,102,189,138,0.53968253968254,0.666666666666667,0.401129943502825,-0.126984126984127
"Chr08","264071","C","T",57,44,101,160,95,64,159,160,0.40251572327044,0.435643564356436,0.584615384615385,-0.0331278410859954
"Chr08","264234","A","G",45,84,129,160,80,76,156,160,0.487179487179487,0.651162790697674,0.43859649122807,-0.163983303518187
"Chr08","265033","T","G",84,109,193,147,97,115,212,147,0.542452830188679,0.564766839378238,0.446913580246914,-0.0223140091895591
"Chr08","265537","A","G",126,60,186,160,99,93,192,160,0.484375,0.32258064516129,0.595238095238095,0.16179435483871
"Chr08","265592","A","G",127,59,186,160,97,109,206,160,0.529126213592233,0.317204301075269,0.571428571428571,0.211921912516964
"Chr08","265969","C","T",54,102,156,139,106,104,210,139,0.495238095238095,0.653846153846154,0.437158469945355,-0.158608058608059
"Chr08","266440","G","A",37,23,60,160,50,47,97,160,0.484536082474227,0.383333333333333,0.554140127388535,0.101202749140893
"Chr08","266814","G","A",44,23,67,160,26,48,74,160,0.648648648648649,0.343283582089552,0.49645390070922,0.305365066559096
"Chr08","266997","G","A",26,17,43,143,24,27,51,143,0.529411764705882,0.395348837209302,0.531914893617021,0.13406292749658
"Chr08","267160","A","T",34,70,104,160,74,67,141,160,0.475177304964539,0.673076923076923,0.440816326530612,-0.197899618112384
"Chr08","267366","T","A",34,38,72,160,39,51,90,160,0.566666666666667,0.527777777777778,0.450617283950617,0.0388888888888889
"Chr08","267456","T","C",27,44,71,140,45,38,83,140,0.457831325301205,0.619718309859155,0.467532467532468,-0.16188698455795
"Chr08","268153","C","A",68,42,110,160,80,80,160,160,0.5,0.381818181818182,0.548148148148148,0.118181818181818
"Chr08","268287","C","T",66,71,137,160,55,78,133,160,0.586466165413534,0.518248175182482,0.448148148148148,0.068217990231052
"Chr08","268404","T","G",67,74,141,160,78,73,151,160,0.483443708609272,0.524822695035461,0.496575342465753,-0.0413789864261894
"Chr08","269263","G","T",77,48,125,143,75,84,159,143,0.528301886792453,0.384,0.535211267605634,0.144301886792453
"Chr08","269720","C","T",63,88,151,160,104,94,198,160,0.474747474747475,0.582781456953642,0.478510028653295,-0.108033982206168
"Chr08","269810","G","T",82,76,158,160,88,95,183,160,0.519125683060109,0.481012658227848,0.498533724340176,0.0381130248322612
"Chr08","271625","T","A",49,96,145,160,87,76,163,160,0.466257668711656,0.662068965517241,0.441558441558442,-0.195811296805585
"Chr08","272071","C","T",82,54,136,137,86,92,178,137,0.51685393258427,0.397058823529412,0.535031847133758,0.119795109054858
"Chr08","272278","A","G",52,98,150,140,92,70,162,140,0.432098765432099,0.653333333333333,0.461538461538462,-0.221234567901235
"Chr08","272413","G","A",54,40,94,142,59,46,105,142,0.438095238095238,0.425531914893617,0.5678391959799,0.0125633232016211
"Chr08","272858","C","T",65,55,120,137,81,94,175,137,0.537142857142857,0.458333333333333,0.494915254237288,0.0788095238095238
"Chr08","273579","G","A",33,33,66,139,45,41,86,139,0.476744186046512,0.5,0.513157894736842,-0.0232558139534884
"Chr08","273597","G","A",23,28,51,160,35,51,86,160,0.593023255813954,0.549019607843137,0.423357664233577,0.0440036479708162
"Chr08","273653","A","G",30,35,65,160,51,57,108,160,0.527777777777778,0.538461538461538,0.468208092485549,-0.0106837606837606
"Chr08","273963","A","G",46,27,73,160,67,55,122,160,0.450819672131148,0.36986301369863,0.57948717948718,0.0809566584325174
"Chr08","275495","T","C",73,57,130,137,96,101,197,137,0.512690355329949,0.438461538461538,0.516819571865443,0.0742288168684108
"Chr08","276312","T","A",54,70,124,160,102,77,179,160,0.430167597765363,0.564516129032258,0.514851485148515,-0.134348531266895
"Chr08","276800","A","G",41,42,83,143,59,49,108,143,0.453703703703704,0.506024096385542,0.523560209424084,-0.0523203926818384
"Chr08","276962","G","A",76,38,114,142,67,86,153,142,0.562091503267974,0.333333333333333,0.535580524344569,0.228758169934641
"Chr08","277480","C","A",70,49,119,139,90,73,163,139,0.447852760736196,0.411764705882353,0.567375886524823,0.0360880548538434
"Chr08","277539","G","A",101,65,166,137,97,106,203,137,0.522167487684729,0.391566265060241,0.536585365853659,0.130601222624488
"Chr08","277603","G","C",56,126,182,160,94,105,199,160,0.527638190954774,0.692307692307692,0.393700787401575,-0.164669501352918
"Chr08","278124","C","T",106,54,160,140,117,108,225,140,0.48,0.3375,0.579220779220779,0.1425
"Chr08","278602","C","T",51,106,157,160,100,74,174,160,0.425287356321839,0.67515923566879,0.45619335347432,-0.249871879346951
"Chr08","279013","G","A",40,76,116,149,72,56,128,149,0.4375,0.655172413793103,0.459016393442623,-0.217672413793103
"Chr08","279044","T","C",47,81,128,160,79,60,139,160,0.431654676258993,0.6328125,0.471910112359551,-0.201157823741007
"Chr08","279894","G","A",45,67,112,160,67,86,153,160,0.562091503267974,0.598214285714286,0.422641509433962,-0.0361227824463118
"Chr08","280518","C","T",50,71,121,160,69,75,144,160,0.520833333333333,0.586776859504132,0.449056603773585,-0.0659435261707989
"Chr08","280685","T","G",51,85,136,160,80,60,140,160,0.428571428571429,0.625,0.47463768115942,-0.196428571428571
"Chr08","280770","G","T",40,73,113,146,58,59,117,146,0.504273504273504,0.646017699115044,0.426086956521739,-0.14174419484154
"Chr08","280778","T","G",44,76,120,154,67,61,128,154,0.4765625,0.633333333333333,0.44758064516129,-0.156770833333333
"Chr08","280847","G","A",42,48,90,160,61,67,128,160,0.5234375,0.533333333333333,0.472477064220183,-0.00989583333333333
"Chr08","280887","C","A",46,61,107,160,53,68,121,160,0.56198347107438,0.570093457943925,0.434210526315789,-0.00810998686954501
"Chr08","280990","A","T",34,77,111,139,67,68,135,139,0.503703703703704,0.693693693693694,0.410569105691057,-0.18998998998999
"Chr08","281224","A","G",57,49,106,136,70,56,126,136,0.444444444444444,0.462264150943396,0.547413793103448,-0.0178197064989518
"Chr08","281373","T","A",42,50,92,160,77,57,134,160,0.425373134328358,0.543478260869565,0.526548672566372,-0.118105126541207
"Chr08","281494","T","C",32,65,97,142,53,77,130,142,0.592307692307692,0.670103092783505,0.374449339207048,-0.0777954004758128
"Chr08","281567","A","G",39,51,90,160,38,67,105,160,0.638095238095238,0.566666666666667,0.394871794871795,0.0714285714285714
"Chr08","281573","C","T",28,49,77,140,29,54,83,140,0.650602409638554,0.636363636363636,0.35625,0.0142387732749178
"Chr08","281581","C","A",30,49,79,159,33,59,92,159,0.641304347826087,0.620253164556962,0.368421052631579,0.0210511832691249
"Chr08","281627","G","C",33,51,84,140,41,50,91,140,0.549450549450549,0.607142857142857,0.422857142857143,-0.0576923076923076
"Chr08","281690","C","T",37,59,96,141,48,50,98,141,0.510204081632653,0.614583333333333,0.438144329896907,-0.10437925170068
"Chr08","281842","T","C",68,90,158,136,101,110,211,136,0.52132701421801,0.569620253164557,0.457994579945799,-0.0482932389465475
"Chr08","282070","G","A",40,64,104,160,80,86,166,160,0.518072289156627,0.615384615384615,0.444444444444444,-0.0973123262279889
"Chr08","282168","A","G",91,118,209,139,130,103,233,139,0.44206008583691,0.564593301435407,0.5,-0.122533215598497
"Chr08","282310","A","T",94,127,221,160,136,111,247,160,0.449392712550607,0.574660633484163,0.491452991452991,-0.125267920933556
"Chr08","282462","T","C",84,92,176,160,130,113,243,160,0.465020576131687,0.522727272727273,0.510739856801909,-0.0577066965955855
"Chr08","282563","C","T",57,101,158,145,116,91,207,145,0.439613526570048,0.639240506329114,0.473972602739726,-0.199626979759066
"Chr08","282599","A","G",45,91,136,160,94,79,173,160,0.456647398843931,0.669117647058823,0.449838187702265,-0.212470248214893
"Chr08","282671","G","C",53,103,156,160,112,89,201,160,0.442786069651741,0.66025641025641,0.46218487394958,-0.217470340604669
"Chr08","282775","T","C",88,79,167,160,134,83,217,160,0.382488479262673,0.473053892215569,0.578125,-0.0905654129528961
"Chr08","282782","G","A",90,72,162,160,125,80,205,160,0.390243902439024,0.444444444444444,0.5858310626703,-0.05420054200542
"Chr08","283055","A","G",50,106,156,156,106,108,214,156,0.504672897196262,0.67948717948718,0.421621621621622,-0.174814282290918
"Chr08","283073","C","G",50,83,133,138,95,88,183,138,0.480874316939891,0.62406015037594,0.458860759493671,-0.143185833436049
"Chr08","283102","C","A",62,86,148,136,102,96,198,136,0.484848484848485,0.581081081081081,0.473988439306358,-0.0962325962325962
"Chr08","283125","A","T",60,91,151,160,112,100,212,160,0.471698113207547,0.602649006622517,0.473829201101928,-0.130950893414969
"Chr08","283169","A","T",60,87,147,160,116,99,215,160,0.46046511627907,0.591836734693878,0.486187845303867,-0.131371618414808
"Chr08","283231","G","C",44,73,117,145,113,93,206,145,0.451456310679612,0.623931623931624,0.486068111455108,-0.172475313252012
"Chr08","283253","C","A",46,86,132,137,112,96,208,137,0.461538461538462,0.651515151515151,0.464705882352941,-0.18997668997669
"Chr08","283267","A","G",47,82,129,136,109,88,197,136,0.446700507614213,0.635658914728682,0.478527607361963,-0.188958407114469
"Chr08","283280","T","A",48,84,132,160,109,86,195,160,0.441025641025641,0.636363636363636,0.480122324159021,-0.195337995337995
"Chr08","283307","A","G",58,88,146,160,119,78,197,160,0.395939086294416,0.602739726027397,0.516034985422741,-0.206800639732981
"Chr08","283315","G","A",64,86,150,152,121,75,196,152,0.38265306122449,0.573333333333333,0.534682080924855,-0.190680272108844
"Chr08","283395","A","G",80,92,172,144,126,84,210,144,0.4,0.534883720930233,0.539267015706806,-0.134883720930232
"Chr08","283413","C","T",77,82,159,137,123,80,203,137,0.394088669950739,0.515723270440252,0.552486187845304,-0.121634600489513
"Chr08","283577","A","T",60,65,125,136,96,70,166,136,0.421686746987952,0.52,0.536082474226804,-0.0983132530120482
"Chr08","283604","T","G",58,74,132,141,102,81,183,141,0.442622950819672,0.560606060606061,0.507936507936508,-0.117983109786388
"Chr08","283625","T","C",86,56,142,136,96,98,194,136,0.505154639175258,0.394366197183099,0.541666666666667,0.110788441992159
"Chr08","283989","C","T",28,83,111,160,62,68,130,160,0.523076923076923,0.747747747747748,0.37344398340249,-0.224670824670825
"Chr08","284085","T","C",31,38,69,141,44,26,70,141,0.371428571428571,0.550724637681159,0.539568345323741,-0.179296066252588
"Chr08","284136","T","C",32,38,70,146,57,26,83,146,0.313253012048193,0.542857142857143,0.581699346405229,-0.22960413080895
"Chr08","284500","T","A",6,16,22,22,19,11,30,120,0.366666666666667,0.727272727272727,0.480769230769231,-0.360606060606061
"Chr08","284514","G","T",13,8,21,124,12,20,32,116,0.625,0.380952380952381,0.471698113207547,0.244047619047619
"Chr08","284578","C","G",9,7,16,142,11,10,21,144,0.476190476190476,0.4375,0.540540540540541,0.0386904761904762
"Chr08","292714","G","A",31,19,50,143,36,39,75,143,0.52,0.38,0.536,0.14
"Chr08","295767","C","A",48,89,137,160,73,88,161,160,0.546583850931677,0.64963503649635,0.406040268456376,-0.103051185564673
"Chr08","295785","G","A",49,82,131,160,77,84,161,160,0.521739130434783,0.625954198473282,0.431506849315068,-0.1042150680385
"Chr08","295967","C","T",39,67,106,136,68,76,144,136,0.527777777777778,0.632075471698113,0.428,-0.104297693920335
"Chr08","296126","C","T",33,50,83,150,54,31,85,150,0.364705882352941,0.602409638554217,0.517857142857143,-0.237703756201276
"Chr08","297313","C","T",33,64,97,160,52,60,112,160,0.535714285714286,0.65979381443299,0.406698564593301,-0.124079528718704
"Chr08","297415","A","G",22,38,60,160,43,40,83,160,0.481927710843373,0.633333333333333,0.454545454545455,-0.15140562248996
"Chr08","297447","G","A",17,37,54,160,41,35,76,160,0.460526315789474,0.685185185185185,0.446153846153846,-0.224658869395712
"Chr08","298042","C","T",28,48,76,160,69,52,121,160,0.429752066115702,0.631578947368421,0.49238578680203,-0.201826881252719
"Chr08","298078","C","T",23,56,79,160,68,65,133,160,0.488721804511278,0.708860759493671,0.429245283018868,-0.220138954982393
"Chr08","298255","G","A",41,45,86,140,70,54,124,140,0.435483870967742,0.523255813953488,0.528571428571429,-0.0877719429857465
"Chr08","298407","C","T",58,55,113,160,83,57,140,160,0.407142857142857,0.486725663716814,0.557312252964427,-0.079582806573957
"Chr08","298847","A","G",52,52,104,141,68,59,127,141,0.464566929133858,0.5,0.519480519480519,-0.0354330708661417
"Chr08","300336","A","G",23,24,47,160,36,36,72,160,0.5,0.51063829787234,0.495798319327731,-0.0106382978723404
"Chr08","301210","C","A",61,94,155,137,88,99,187,137,0.529411764705882,0.606451612903226,0.435672514619883,-0.0770398481973434
"Chr08","301258","G","A",66,117,183,136,94,97,191,136,0.507853403141361,0.639344262295082,0.427807486631016,-0.131490859153721
"Chr08","301265","T","C",68,125,193,141,98,97,195,141,0.497435897435897,0.647668393782383,0.427835051546392,-0.150232496346486
"Chr08","301273","A","C",71,129,200,139,93,106,199,139,0.532663316582915,0.645,0.411027568922306,-0.112336683417085
"Chr08","301312","A","T",83,142,225,160,97,123,220,160,0.559090909090909,0.631111111111111,0.404494382022472,-0.072020202020202
"Chr08","301829","C","G",98,52,150,136,96,99,195,136,0.507692307692308,0.346666666666667,0.56231884057971,0.161025641025641
"Chr08","301871","C","T",58,90,148,160,105,92,197,160,0.467005076142132,0.608108108108108,0.472463768115942,-0.141103031965976
"Chr08","301991","A","G",116,65,181,136,100,81,181,136,0.447513812154696,0.359116022099448,0.596685082872928,0.0883977900552486
"Chr08","302182","C","T",42,91,133,140,100,72,172,140,0.418604651162791,0.684210526315789,0.465573770491803,-0.265605875152999
"Chr08","302425","A","G",63,115,178,143,96,87,183,143,0.475409836065574,0.646067415730337,0.440443213296399,-0.170657579664763
"Chr08","303361","G","A",68,86,154,142,88,66,154,142,0.428571428571429,0.558441558441558,0.506493506493506,-0.12987012987013
"Chr08","305118","G","A",43,20,63,151,40,53,93,151,0.56989247311828,0.317460317460317,0.532051282051282,0.252432155657962
"Chr08","305464","C","T",58,18,76,145,65,74,139,145,0.532374100719424,0.236842105263158,0.572093023255814,0.295531995456267
"Chr08","306306","G","A",38,26,64,160,44,60,104,160,0.576923076923077,0.40625,0.488095238095238,0.170673076923077
"Chr08","306323","C","T",28,42,70,160,58,35,93,160,0.376344086021505,0.6,0.52760736196319,-0.223655913978495
"Chr08","306422","G","A",43,27,70,142,26,49,75,142,0.653333333333333,0.385714285714286,0.475862068965517,0.267619047619048
"Chr08","306511","C","T",39,37,76,141,24,63,87,141,0.724137931034483,0.486842105263158,0.386503067484663,0.237295825771325
"Chr08","309840","C","T",11,43,54,145,24,26,50,145,0.52,0.796296296296296,0.336538461538462,-0.276296296296296
"Chr08","310071","C","T",14,18,32,160,27,20,47,160,0.425531914893617,0.5625,0.518987341772152,-0.136968085106383
"Chr08","311577","G","A",28,16,44,160,52,49,101,160,0.485148514851485,0.363636363636364,0.551724137931034,0.121512151215121
"Chr08","311636","C","A",37,22,59,160,59,55,114,160,0.482456140350877,0.372881355932203,0.554913294797688,0.109574784418674
"Chr08","311703","G","A",21,34,55,139,34,50,84,139,0.595238095238095,0.618181818181818,0.39568345323741,-0.0229437229437229
"Chr08","312175","T","A",57,36,93,141,50,48,98,141,0.489795918367347,0.387096774193548,0.56020942408377,0.102699144173799
"Chr08","312249","A","G",41,56,97,160,68,80,148,160,0.540540540540541,0.577319587628866,0.444897959183673,-0.0367790470883254
"Chr08","312262","T","A",60,43,103,139,81,77,158,139,0.487341772151899,0.41747572815534,0.540229885057471,0.0698660439965589
"Chr08","312930","C","A",12,19,31,160,13,12,25,160,0.48,0.612903225806452,0.446428571428571,-0.132903225806452
"Chr08","313479","C","T",39,45,84,160,51,66,117,160,0.564102564102564,0.535714285714286,0.447761194029851,0.0283882783882784
"Chr08","314179","A","C",70,45,115,160,60,83,143,160,0.58041958041958,0.391304347826087,0.503875968992248,0.189115232593493
"Chr08","314783","G","A",46,73,119,160,82,88,170,160,0.517647058823529,0.613445378151261,0.442906574394464,-0.0957983193277311
"Chr08","314848","C","T",44,60,104,160,74,63,137,160,0.45985401459854,0.576923076923077,0.489626556016597,-0.117069062324537
"Chr08","315306","A","T",31,25,56,160,43,39,82,160,0.475609756097561,0.446428571428571,0.536231884057971,0.0291811846689895
"Chr08","315466","C","A",49,61,110,160,62,66,128,160,0.515625,0.554545454545455,0.466386554621849,-0.0389204545454546
"Chr08","315473","G","A",60,49,109,141,66,62,128,141,0.484375,0.44954128440367,0.531645569620253,0.0348337155963303
"Chr08","315539","T","C",41,54,95,160,54,59,113,160,0.52212389380531,0.568421052631579,0.456730769230769,-0.0462971588262692
"Chr08","316526","C","T",26,23,49,156,24,11,35,156,0.314285714285714,0.469387755102041,0.595238095238095,-0.155102040816327
"Chr08","317248","T","C",50,33,83,143,51,69,120,143,0.575,0.397590361445783,0.497536945812808,0.177409638554217
"Chr08","321976","C","A",86,66,152,137,72,84,156,137,0.538461538461538,0.434210526315789,0.512987012987013,0.104251012145749
"Chr08","322656","T","A",119,67,186,160,114,112,226,160,0.495575221238938,0.360215053763441,0.565533980582524,0.135360167475497
"Chr08","324273","C","T",7,34,41,64,14,24,38,147,0.631578947368421,0.829268292682927,0.265822784810127,-0.197689345314506
"Chr08","324922","G","A",95,50,145,160,86,105,191,160,0.549738219895288,0.344827586206897,0.538690476190476,0.204910633688391
"Chr08","325373","A","T",74,71,145,160,100,107,207,160,0.516908212560386,0.489655172413793,0.494318181818182,0.0272530401465934
"Chr08","326752","G","A",89,50,139,160,93,94,187,160,0.502673796791444,0.359712230215827,0.558282208588957,0.142961566575617
"Chr08","327444","A","G",37,73,110,160,93,76,169,160,0.449704142011834,0.663636363636364,0.46594982078853,-0.213932221624529
"Chr08","328116","T","C",71,93,164,142,95,68,163,142,0.417177914110429,0.567073170731707,0.507645259938838,-0.149895256621278
"Chr08","328628","C","T",93,83,176,160,97,98,195,160,0.502564102564103,0.471590909090909,0.512129380053908,0.0309731934731934
"Chr08","328929","C","T",69,120,189,160,131,127,258,160,0.492248062015504,0.634920634920635,0.447427293064877,-0.142672572905131
"Chr08","334381","G","A",51,109,160,160,77,69,146,160,0.472602739726027,0.68125,0.418300653594771,-0.208647260273973
"Chr08","334975","C","T",59,43,102,154,88,80,168,154,0.476190476190476,0.42156862745098,0.544444444444444,0.0546218487394958
"Chr08","335142","T","G",64,31,95,140,84,80,164,140,0.48780487804878,0.326315789473684,0.571428571428571,0.161489088575096
"Chr08","335570","G","A",29,61,90,139,44,65,109,139,0.596330275229358,0.677777777777778,0.366834170854271,-0.08144750254842
"Chr08","335657","G","A",104,41,145,160,76,71,147,160,0.482993197278912,0.282758620689655,0.616438356164384,0.200234576589256
"Chr08","335841","T","G",81,42,123,160,94,67,161,160,0.416149068322981,0.341463414634146,0.616197183098592,0.074685653688835
"Chr08","337081","A","G",44,93,137,160,63,65,128,160,0.5078125,0.678832116788321,0.40377358490566,-0.171019616788321
"Chr08","339143","G","A",39,40,79,140,49,49,98,140,0.5,0.506329113924051,0.497175141242938,-0.00632911392405067
"Chr08","339297","T","A",30,50,80,143,42,38,80,143,0.475,0.625,0.45,-0.15
"Chr08","340966","G","A",54,81,135,160,89,64,153,160,0.418300653594771,0.6,0.496527777777778,-0.181699346405229
"Chr08","341030","C","T",82,68,150,160,92,84,176,160,0.477272727272727,0.453333333333333,0.533742331288344,0.023939393939394
"Chr08","341136","G","C",87,44,131,160,95,76,171,160,0.444444444444444,0.33587786259542,0.602649006622517,0.108566581849025
"Chr08","343410","A","C",74,43,117,160,59,79,138,160,0.572463768115942,0.367521367521368,0.52156862745098,0.204942400594574
"Chr08","343953","C","T",10,40,50,137,52,37,89,160,0.415730337078652,0.8,0.446043165467626,-0.384269662921348
"Chr08","344386","G","T",58,23,81,139,51,65,116,139,0.560344827586207,0.283950617283951,0.553299492385787,0.276394210302256
"Chr08","345157","G","A",64,46,110,140,53,55,108,140,0.509259259259259,0.418181818181818,0.536697247706422,0.0910774410774411
"Chr08","345319","C","T",30,40,70,160,59,33,92,160,0.358695652173913,0.571428571428571,0.549382716049383,-0.212732919254658
"Chr08","345333","T","A",32,37,69,152,56,31,87,152,0.35632183908046,0.536231884057971,0.564102564102564,-0.179910044977511
"Chr08","345452","C","A",40,27,67,160,65,43,108,160,0.398148148148148,0.402985074626866,0.6,-0.00483692647871753
"Chr08","345464","C","T",25,46,71,145,46,59,105,145,0.561904761904762,0.647887323943662,0.403409090909091,-0.0859825620389001
"Chr08","345481","C","T",52,30,82,160,58,47,105,160,0.447619047619048,0.365853658536585,0.588235294117647,0.0817653890824623
"Chr08","345504","A","G",53,27,80,160,64,52,116,160,0.448275862068966,0.3375,0.596938775510204,0.110775862068966
"Chr08","345681","T","C",62,18,80,160,47,42,89,160,0.471910112359551,0.225,0.644970414201183,0.246910112359551
"Chr08","346582","C","A",30,47,77,146,52,49,101,146,0.485148514851485,0.61038961038961,0.460674157303371,-0.125241095538125
"Chr08","346598","T","C",36,47,83,139,49,50,99,139,0.505050505050505,0.566265060240964,0.467032967032967,-0.0612145551904588
"Chr08","346616","G","A",41,27,68,141,48,45,93,141,0.483870967741935,0.397058823529412,0.552795031055901,0.0868121442125238
"Chr08","346620","T","C",26,41,67,160,43,47,90,160,0.522222222222222,0.611940298507463,0.439490445859873,-0.0897180762852404
"Chr08","346683","G","A",34,22,56,160,38,41,79,160,0.518987341772152,0.392857142857143,0.533333333333333,0.126130198915009
"Chr08","346741","C","A",26,18,44,146,38,29,67,146,0.432835820895522,0.409090909090909,0.576576576576577,0.0237449118046132
"Chr08","346746","G","C",17,23,40,160,28,34,62,160,0.548387096774194,0.575,0.441176470588235,-0.0266129032258065
"Chr08","347376","C","T",26,54,80,160,61,45,106,160,0.424528301886792,0.675,0.467741935483871,-0.250471698113208
"Chr08","347460","T","G",30,51,81,140,73,60,133,140,0.451127819548872,0.62962962962963,0.481308411214953,-0.178501810080757
"Chr08","347543","C","T",52,96,148,160,96,90,186,160,0.483870967741935,0.648648648648649,0.44311377245509,-0.164777680906713
"Chr08","347665","G","A",92,65,157,160,107,100,207,160,0.483091787439614,0.414012738853503,0.546703296703297,0.0690790485861103
"Chr08","347710","T","C",47,67,114,136,89,86,175,136,0.491428571428571,0.587719298245614,0.470588235294118,-0.0962907268170426
"Chr08","347974","G","A",109,65,174,160,98,97,195,160,0.497435897435897,0.373563218390805,0.560975609756098,0.123872679045093
"Chr08","348215","T","C",55,99,154,135,81,95,176,135,0.539772727272727,0.642857142857143,0.412121212121212,-0.103084415584416
"Chr08","348565","G","A",67,39,106,140,66,51,117,140,0.435897435897436,0.367924528301887,0.596412556053812,0.0679729075955491
"Chr08","348758","C","T",63,45,108,160,78,58,136,160,0.426470588235294,0.416666666666667,0.577868852459016,0.00980392156862742
"Chr08","348764","C","T",44,58,102,140,54,77,131,140,0.587786259541985,0.568627450980392,0.420600858369099,0.0191588085615926
"Chr08","348791","T","C",36,62,98,160,54,84,138,160,0.608695652173913,0.63265306122449,0.38135593220339,-0.0239574090505768
"Chr08","348989","A","G",85,33,118,149,66,51,117,149,0.435897435897436,0.279661016949153,0.642553191489362,0.156236418948283
"Chr08","349190","C","T",72,44,116,160,67,43,110,160,0.390909090909091,0.379310344827586,0.615044247787611,0.0115987460815047
"Chr08","366963","A","T",123,77,200,160,139,132,271,160,0.487084870848708,0.385,0.556263269639066,0.102084870848708
"Chr08","367730","G","A",102,81,183,160,116,105,221,160,0.475113122171946,0.442622950819672,0.53960396039604,0.0324901713522736
"Chr08","367913","G","A",92,68,160,160,111,83,194,160,0.427835051546392,0.425,0.573446327683616,0.00283505154639174
"Chr08","367964","C","T",59,106,165,160,87,104,191,160,0.544502617801047,0.642424242424242,0.410112359550562,-0.0979216246231953
"Chr08","368048","C","T",70,33,103,160,72,67,139,160,0.482014388489209,0.320388349514563,0.586776859504132,0.161626038974646
"Chr08","368105","C","T",35,64,99,141,60,70,130,141,0.538461538461538,0.646464646464647,0.414847161572052,-0.108003108003108
"Chr08","368153","G","A",42,78,120,140,66,63,129,140,0.488372093023256,0.65,0.433734939759036,-0.161627906976744
"Chr08","368190","C","G",73,44,117,160,54,62,116,160,0.53448275862069,0.376068376068376,0.545064377682403,0.158414382552314
"Chr08","368340","A","G",39,79,118,160,70,82,152,160,0.539473684210526,0.669491525423729,0.403703703703704,-0.130017841213202
"Chr08","368381","C","T",47,80,127,160,68,69,137,160,0.503649635036496,0.62992125984252,0.435606060606061,-0.126271624806023
"Chr08","368555","G","A",51,77,128,160,85,74,159,160,0.465408805031447,0.6015625,0.473867595818815,-0.136153694968553
"Chr08","369373","C","T",53,77,130,160,77,77,154,160,0.5,0.592307692307692,0.457746478873239,-0.0923076923076923
"Chr08","373663","A","C",76,102,178,137,84,93,177,137,0.525423728813559,0.573033707865168,0.450704225352113,-0.0476099790516091
"Chr08","374007","C","A",58,84,142,137,94,90,184,137,0.489130434782609,0.591549295774648,0.466257668711656,-0.102418860992039
"Chr08","374075","G","C",94,54,148,160,88,102,190,160,0.536842105263158,0.364864864864865,0.538461538461538,0.171977240398293
"Chr08","374170","G","A",90,53,143,140,102,101,203,140,0.497536945812808,0.370629370629371,0.554913294797688,0.126907575183437
"Chr08","374539","C","T",91,51,142,160,83,93,176,160,0.528409090909091,0.359154929577465,0.547169811320755,0.169254161331626
"Chr08","374837","T","A",109,54,163,160,93,97,190,160,0.510526315789474,0.331288343558282,0.572237960339943,0.179237972231192
"Chr08","376331","T","C",89,97,186,160,97,91,188,160,0.484042553191489,0.521505376344086,0.497326203208556,-0.0374628231525966
"Chr08","376935","G","A",118,60,178,160,109,92,201,160,0.45771144278607,0.337078651685393,0.598944591029024,0.120632791100676
"Chr08","377029","G","C",131,70,201,136,129,82,211,136,0.388625592417062,0.348258706467662,0.631067961165049,0.0403668859493999
"Chr08","377153","T","A",109,57,166,137,96,68,164,137,0.414634146341463,0.343373493975904,0.621212121212121,0.0712606523655598
"Chr08","377394","T","C",110,67,177,160,106,85,191,160,0.445026178010471,0.378531073446328,0.58695652173913,0.0664951045641435
"Chr08","377492","T","C",81,56,137,160,68,63,131,160,0.480916030534351,0.408759124087591,0.555970149253731,0.0721569064467599
"Chr08","377544","C","G",75,50,125,160,60,51,111,160,0.459459459459459,0.4,0.572033898305085,0.0594594594594595
"Chr08","378011","T","C",58,44,102,147,53,38,91,147,0.417582417582418,0.431372549019608,0.575129533678757,-0.0137901314371903
"Chr08","378236","C","T",46,33,79,160,28,51,79,160,0.645569620253165,0.417721518987342,0.468354430379747,0.227848101265823
"Chr08","378343","A","G",37,31,68,148,25,36,61,148,0.590163934426229,0.455882352941176,0.48062015503876,0.134281581485053
"Chr08","378387","G","C",31,33,64,160,30,41,71,160,0.577464788732394,0.515625,0.451851851851852,0.0618397887323944
"Chr08","378392","C","T",30,35,65,141,31,41,72,141,0.569444444444444,0.538461538461538,0.445255474452555,0.030982905982906
"Chr08","378476","G","A",33,43,76,151,29,45,74,151,0.608108108108108,0.565789473684211,0.413333333333333,0.0423186344238976
"Chr08","378485","A","G",31,40,71,142,26,44,70,142,0.628571428571429,0.563380281690141,0.404255319148936,0.0651911468812877
"Chr08","378505","A","G",28,30,58,153,24,38,62,153,0.612903225806452,0.517241379310345,0.433333333333333,0.0956618464961068
"Chr08","378527","T","G",21,22,43,140,18,29,47,140,0.617021276595745,0.511627906976744,0.433333333333333,0.105393369619
"Chr08","378774","C","A",45,40,85,160,54,45,99,160,0.454545454545455,0.470588235294118,0.53804347826087,-0.0160427807486631
"Chr08","378791","A","G",41,42,83,160,55,55,110,160,0.5,0.506024096385542,0.49740932642487,-0.00602409638554213
"Chr08","378914","C","T",74,33,107,160,82,67,149,160,0.449664429530201,0.308411214953271,0.609375,0.14125321457693
"Chr08","378929","G","A",66,28,94,136,73,62,135,136,0.459259259259259,0.297872340425532,0.606986899563319,0.161386918833727
"Chr08","378941","A","G",66,28,94,160,66,56,122,160,0.459016393442623,0.297872340425532,0.611111111111111,0.161144053017091
"Chr08","378957","A","G",61,26,87,160,62,54,116,160,0.46551724137931,0.298850574712644,0.605911330049261,0.166666666666667
"Chr08","378971","A","G",60,24,84,160,57,49,106,160,0.462264150943396,0.285714285714286,0.615789473684211,0.176549865229111
"Chr08","379064","G","A",65,35,100,160,63,56,119,160,0.470588235294118,0.35,0.584474885844749,0.120588235294118
"Chr08","379073","C","G",62,32,94,160,66,59,125,160,0.472,0.340425531914894,0.584474885844749,0.131574468085106
"Chr08","379074","C","A",32,63,95,160,60,65,125,160,0.52,0.663157894736842,0.418181818181818,-0.143157894736842
"Chr08","379092","G","A",79,37,116,160,74,73,147,160,0.496598639455782,0.318965517241379,0.581749049429658,0.177633122214403
"Chr08","379360","C","T",59,33,92,140,41,45,86,140,0.523255813953488,0.358695652173913,0.561797752808989,0.164560161779575
"Chr08","379758","C","T",77,51,128,160,78,69,147,160,0.469387755102041,0.3984375,0.563636363636364,0.0709502551020408
"Chr08","383151","T","C",75,35,110,160,61,49,110,160,0.445454545454545,0.318181818181818,0.618181818181818,0.127272727272727
"Chr08","386728","A","G",58,79,137,160,89,72,161,160,0.447204968944099,0.576642335766423,0.493288590604027,-0.129437366822324
"Chr08","387208","A","G",48,60,108,149,74,57,131,149,0.435114503816794,0.555555555555556,0.510460251046025,-0.120441051738762
"Chr08","387442","G","A",13,37,50,145,37,38,75,145,0.506666666666667,0.74,0.4,-0.233333333333333
"Chr08","388062","G","A",15,36,51,140,39,28,67,140,0.417910447761194,0.705882352941177,0.457627118644068,-0.287971905179983
"Chr08","388849","T","G",69,79,148,160,100,100,200,160,0.5,0.533783783783784,0.485632183908046,-0.0337837837837838
"Chr08","389498","C","T",51,64,115,160,90,75,165,160,0.454545454545455,0.556521739130435,0.503571428571429,-0.10197628458498
"Chr08","389652","A","T",71,109,180,160,117,139,256,160,0.54296875,0.605555555555556,0.431192660550459,-0.0625868055555555
"Chr08","397491","G","A",55,30,85,140,57,47,104,140,0.451923076923077,0.352941176470588,0.592592592592593,0.0989819004524887
"Chr08","397811","C","T",32,21,53,146,43,36,79,146,0.455696202531646,0.39622641509434,0.568181818181818,0.0594697874373059
"Chr08","402064","G","A",68,42,110,160,63,75,138,160,0.543478260869565,0.381818181818182,0.528225806451613,0.161660079051383
"Chr08","403333","G","A",72,60,132,160,78,82,160,160,0.5125,0.454545454545455,0.513698630136986,0.0579545454545454
"Chr08","404650","G","A",35,22,57,143,50,43,93,143,0.462365591397849,0.385964912280702,0.566666666666667,0.0764006791171477
"Chr08","404762","C","A",68,46,114,143,74,87,161,143,0.540372670807453,0.403508771929825,0.516363636363636,0.136863898877629
"Chr08","404914","T","G",55,53,108,160,58,80,138,160,0.579710144927536,0.490740740740741,0.459349593495935,0.0889694041867955
"Chr08","405069","A","G",53,32,85,142,59,52,111,142,0.468468468468468,0.376470588235294,0.571428571428571,0.0919978802331743
"Chr08","405161","A","G",34,26,60,160,48,43,91,160,0.472527472527473,0.433333333333333,0.543046357615894,0.0391941391941392
"Chr08","405368","C","T",53,42,95,160,66,47,113,160,0.415929203539823,0.442105263157895,0.572115384615385,-0.0261760596180717
"Chr08","405441","C","T",42,37,79,139,43,55,98,139,0.561224489795918,0.468354430379747,0.480225988700565,0.0928700594161715
"Chr08","405498","A","C",57,41,98,160,60,48,108,160,0.444444444444444,0.418367346938776,0.567961165048544,0.0260770975056689
"Chr08","405583","G","T",46,54,100,160,56,48,104,160,0.461538461538462,0.54,0.5,-0.0784615384615385
"Chr08","407132","T","G",95,57,152,137,94,77,171,137,0.450292397660819,0.375,0.585139318885449,0.0752923976608187
"Chr08","407185","T","A",79,57,136,138,89,77,166,138,0.463855421686747,0.419117647058824,0.556291390728477,0.0447377746279234
"Chr08","407207","T","A",67,88,155,136,88,85,173,136,0.491329479768786,0.567741935483871,0.472560975609756,-0.0764124557150849
"Chr08","407225","G","A",70,88,158,160,87,94,181,160,0.519337016574586,0.556962025316456,0.463126843657817,-0.03762500874187
"Chr08","407245","G","A",72,87,159,136,88,90,178,136,0.50561797752809,0.547169811320755,0.474777448071217,-0.0415518337926648
"Chr08","407258","A","G",76,93,169,160,95,99,194,160,0.510309278350515,0.550295857988166,0.471074380165289,-0.0399865796376503
"Chr08","407280","T","C",81,102,183,140,96,101,197,140,0.512690355329949,0.557377049180328,0.465789473684211,-0.0446866938503786
"Chr08","407291","G","A",84,112,196,160,98,99,197,160,0.50253807106599,0.571428571428571,0.463104325699746,-0.0688905003625816
"Chr08","407331","T","C",69,96,165,142,78,81,159,142,0.509433962264151,0.581818181818182,0.453703703703704,-0.0723842195540308
"Chr08","408865","T","C",83,40,123,148,65,79,144,148,0.548611111111111,0.32520325203252,0.554307116104869,0.223407859078591
"Chr08","408910","C","A",98,47,145,160,84,81,165,160,0.490909090909091,0.324137931034483,0.587096774193548,0.166771159874608
"Chr08","409072","C","T",76,51,127,140,83,75,158,140,0.474683544303797,0.401574803149606,0.557894736842105,0.0731087411541911
"Chr08","409088","G","A",49,77,126,139,74,83,157,139,0.528662420382166,0.611111111111111,0.434628975265018,-0.0824486907289456
"Chr08","409224","C","T",65,40,105,142,68,72,140,142,0.514285714285714,0.380952380952381,0.542857142857143,0.133333333333333
"Chr08","409291","G","A",78,52,130,144,100,69,169,144,0.408284023668639,0.4,0.595317725752508,0.00828402366863901
"Chr08","409342","C","A",49,75,124,149,67,73,140,149,0.521428571428571,0.604838709677419,0.439393939393939,-0.0834101382488479
"Chr08","409942","C","T",42,64,106,160,53,75,128,160,0.5859375,0.60377358490566,0.405982905982906,-0.0178360849056604
"Chr08","410015","G","A",85,52,137,160,72,68,140,160,0.485714285714286,0.37956204379562,0.566787003610108,0.106152241918665
"Chr08","410076","C","T",60,71,131,142,83,82,165,142,0.496969696969697,0.541984732824427,0.483108108108108,-0.0450150358547305
"Chr08","410837","T","C",71,46,117,160,64,85,149,160,0.570469798657718,0.393162393162393,0.507518796992481,0.177307405495325
"Chr08","411606","C","T",39,56,95,151,52,72,124,151,0.580645161290323,0.589473684210526,0.415525114155251,-0.00882852292020364
"Chr08","415120","A","T",71,51,122,160,84,75,159,160,0.471698113207547,0.418032786885246,0.551601423487544,0.0536653263223013
"Chr08","415768","A","G",100,66,166,160,99,91,190,160,0.478947368421053,0.397590361445783,0.558988764044944,0.0813570069752695
"Chr08","416788","A","G",25,35,60,140,39,19,58,140,0.327586206896552,0.583333333333333,0.542372881355932,-0.255747126436782
"Chr08","417168","A","G",20,10,30,148,24,28,52,148,0.538461538461538,0.333333333333333,0.536585365853659,0.205128205128205
"Chr08","417302","G","T",19,19,38,160,25,36,61,160,0.590163934426229,0.5,0.444444444444444,0.0901639344262295
"Chr08","417426","G","A",13,14,27,160,33,34,67,160,0.507462686567164,0.518518518518518,0.48936170212766,-0.0110558319513543
"Chr08","417576","G","A",29,28,57,140,40,37,77,140,0.480519480519481,0.491228070175439,0.514925373134328,-0.0107085896559581
"Chr08","417582","A","C",32,29,61,160,35,37,72,160,0.513888888888889,0.475409836065574,0.503759398496241,0.0384790528233151
"Chr08","417621","G","A",57,41,98,140,53,56,109,140,0.513761467889908,0.418367346938776,0.531400966183575,0.0953941209511328
"Chr08","417846","A","G",29,40,69,160,28,41,69,160,0.594202898550725,0.579710144927536,0.41304347826087,0.0144927536231884
"Chr08","418028","G","C",49,74,123,160,73,76,149,160,0.51006711409396,0.601626016260163,0.448529411764706,-0.0915589021662029
"Chr08","418049","T","C",43,72,115,160,73,84,157,160,0.535031847133758,0.626086956521739,0.426470588235294,-0.0910551093879812
"Chr08","419127","C","T",22,43,65,146,31,39,70,146,0.557142857142857,0.661538461538462,0.392592592592593,-0.104395604395604
"Chr08","419176","C","T",22,38,60,160,26,39,65,160,0.6,0.633333333333333,0.384,-0.0333333333333333
"Chr08","419303","G","A",39,24,63,147,44,34,78,147,0.435897435897436,0.380952380952381,0.588652482269504,0.054945054945055
"Chr08","421151","A","T",41,73,114,150,66,67,133,150,0.503759398496241,0.640350877192982,0.433198380566802,-0.136591478696742
"Chr08","421327","T","A",75,54,129,160,68,69,137,160,0.503649635036496,0.418604651162791,0.537593984962406,0.0850449838737057
"Chr08","421341","A","G",54,60,114,160,80,59,139,160,0.424460431654676,0.526315789473684,0.529644268774704,-0.101855357819008
"Chr08","421360","A","G",56,73,129,142,92,70,162,142,0.432098765432099,0.565891472868217,0.508591065292096,-0.133792707436118
"Chr08","421371","A","G",51,74,125,160,84,67,151,160,0.443708609271523,0.592,0.489130434782609,-0.148291390728477
"Chr08","421437","T","G",41,67,108,147,84,81,165,147,0.490909090909091,0.62037037037037,0.457875457875458,-0.129461279461279
"Chr08","421450","A","G",37,63,100,160,84,77,161,160,0.478260869565217,0.63,0.46360153256705,-0.151739130434783
"Chr08","421455","A","G",37,61,98,140,85,78,163,140,0.478527607361963,0.622448979591837,0.467432950191571,-0.143921372229874
"Chr08","421463","G","C",36,55,91,160,82,62,144,160,0.430555555555556,0.604395604395604,0.502127659574468,-0.173840048840049
"Chr08","421517","G","A",37,58,95,160,55,70,125,160,0.56,0.610526315789474,0.418181818181818,-0.0505263157894736
"Chr08","421523","T","C",38,60,98,139,55,71,126,139,0.563492063492063,0.612244897959184,0.415178571428571,-0.0487528344671202
"Chr08","421583","T","G",43,54,97,160,65,61,126,160,0.484126984126984,0.556701030927835,0.484304932735426,-0.0725740468008509
"Chr08","421760","C","T",73,48,121,160,74,69,143,160,0.482517482517482,0.396694214876033,0.556818181818182,0.0858232676414494
"Chr08","421763","G","A",45,74,119,160,74,78,152,160,0.513157894736842,0.621848739495798,0.439114391143911,-0.108690844758956
"Chr08","421864","A","G",42,44,86,142,92,72,164,142,0.439024390243902,0.511627906976744,0.536,-0.0726035167328418
"Chr08","421881","C","T",45,38,83,142,73,92,165,142,0.557575757575758,0.457831325301205,0.475806451612903,0.0997444322745528
"Chr08","421909","C","T",33,52,85,160,90,62,152,160,0.407894736842105,0.611764705882353,0.518987341772152,-0.203869969040248
"Chr08","421925","C","T",29,49,78,139,67,67,134,139,0.5,0.628205128205128,0.452830188679245,-0.128205128205128
"Chr08","421933","A","G",31,49,80,160,64,69,133,160,0.518796992481203,0.6125,0.446009389671362,-0.093703007518797
"Chr08","421952","C","T",44,70,114,160,70,82,152,160,0.539473684210526,0.614035087719298,0.428571428571429,-0.0745614035087719
"Chr08","421957","C","T",43,69,112,160,68,78,146,160,0.534246575342466,0.616071428571429,0.430232558139535,-0.0818248532289628
"Chr08","421978","C","T",46,69,115,160,73,90,163,160,0.552147239263804,0.6,0.428057553956835,-0.0478527607361963
"Chr08","422008","A","G",55,75,130,160,87,88,175,160,0.502857142857143,0.576923076923077,0.465573770491803,-0.074065934065934
"Chr08","422023","G","A",63,73,136,160,86,85,171,160,0.497076023391813,0.536764705882353,0.485342019543974,-0.0396886824905401
"Chr08","422036","G","T",65,67,132,139,75,83,158,139,0.525316455696203,0.507575757575758,0.482758620689655,0.017740698120445
"Chr08","422208","C","T",49,69,118,160,57,66,123,160,0.536585365853659,0.584745762711864,0.439834024896266,-0.0481603968582058
"Chr08","423232","C","T",28,60,88,142,46,58,104,142,0.557692307692308,0.681818181818182,0.385416666666667,-0.124125874125874
"Chr08","423755","C","G",11,73,84,0,28,72,100,160,0.72,0.869047619047619,0.21195652173913,-0.149047619047619
"Chr08","424314","C","G",38,66,104,160,35,78,113,160,0.690265486725664,0.634615384615385,0.336405529953917,0.0556501021102791
"Chr08","424325","T","C",36,65,101,160,30,78,108,160,0.722222222222222,0.643564356435644,0.315789473684211,0.0786578657865786
"Chr08","424475","A","C",64,110,174,136,74,84,158,136,0.531645569620253,0.632183908045977,0.41566265060241,-0.100538338425724
"Chr08","424485","G","A",49,94,143,139,51,72,123,139,0.585365853658537,0.657342657342657,0.37593984962406,-0.0719768036841207
"Chr08","424732","C","T",54,83,137,160,56,82,138,160,0.594202898550725,0.605839416058394,0.4,-0.0116365175076696
"Chr08","424756","T","A",49,64,113,160,65,75,140,160,0.535714285714286,0.566371681415929,0.450592885375494,-0.0306573957016435
"Chr08","424780","T","C",42,63,105,160,72,76,148,160,0.513513513513513,0.6,0.450592885375494,-0.0864864864864865
"Chr08","424845","G","A",49,75,124,145,81,87,168,145,0.517857142857143,0.604838709677419,0.445205479452055,-0.0869815668202765
"Chr08","424869","G","A",51,87,138,139,86,95,181,139,0.524861878453039,0.630434782608696,0.429467084639498,-0.105572904155657
"Chr08","424936","C","T",60,65,125,139,61,63,124,139,0.508064516129032,0.52,0.485943775100402,-0.0119354838709678
"Chr08","424964","G","A",61,69,130,141,65,71,136,141,0.522058823529412,0.530769230769231,0.473684210526316,-0.00871040723981897
"Chr08","424990","T","A",57,83,140,141,63,69,132,141,0.522727272727273,0.592857142857143,0.441176470588235,-0.0701298701298702
"Chr08","425090","T","C",56,87,143,160,75,61,136,160,0.448529411764706,0.608391608391608,0.469534050179211,-0.159862196626903
"Chr08","425163","T","C",58,76,134,141,66,83,149,141,0.557046979865772,0.567164179104478,0.438162544169611,-0.0101171992387058
"Chr08","425291","A","G",74,40,114,146,58,63,121,146,0.520661157024793,0.350877192982456,0.561702127659575,0.169783964042337
"Chr08","425293","C","G",37,74,111,160,59,59,118,160,0.5,0.666666666666667,0.419213973799127,-0.166666666666667
"Chr08","426151","G","C",20,44,64,160,33,32,65,160,0.492307692307692,0.6875,0.410852713178295,-0.195192307692308
"Chr08","426326","G","A",33,72,105,160,61,58,119,160,0.487394957983193,0.685714285714286,0.419642857142857,-0.198319327731092
"Chr08","426346","T","C",34,85,119,160,64,66,130,160,0.507692307692308,0.714285714285714,0.393574297188755,-0.206593406593407
"Chr08","426364","T","C",36,86,122,138,73,68,141,138,0.482269503546099,0.704918032786885,0.414448669201521,-0.222648529240786
"Chr08","426411","G","A",41,68,109,139,87,63,150,139,0.42,0.623853211009174,0.494208494208494,-0.203853211009174
"Chr08","426449","G","A",27,79,106,153,61,60,121,153,0.495867768595041,0.745283018867924,0.387665198237885,-0.249415250272883
"Chr08","426474","C","G",25,86,111,160,63,62,125,160,0.496,0.774774774774775,0.372881355932203,-0.278774774774775
"Chr08","426519","C","G",28,77,105,160,50,59,109,160,0.541284403669725,0.733333333333333,0.364485981308411,-0.192048929663609
"Chr08","426528","A","G",28,71,99,160,49,54,103,160,0.524271844660194,0.717171717171717,0.381188118811881,-0.192899872511523
"Chr08","426908","T","G",58,63,121,160,76,61,137,160,0.445255474452555,0.520661157024793,0.51937984496124,-0.0754056825722387
"Chr08","426954","T","C",48,65,113,151,73,80,153,151,0.522875816993464,0.575221238938053,0.454887218045113,-0.052345421944589
"Chr08","426960","T","C",49,56,105,160,69,81,150,160,0.54,0.533333333333333,0.462745098039216,0.00666666666666671
"Chr08","426983","T","A",51,56,107,160,71,77,148,160,0.52027027027027,0.523364485981308,0.47843137254902,-0.00309421571103807
"Chr08","427175","G","A",47,63,110,136,67,67,134,136,0.5,0.572727272727273,0.467213114754098,-0.0727272727272728
"Chr08","427518","C","G",67,89,156,141,109,101,210,141,0.480952380952381,0.57051282051282,0.480874316939891,-0.0895604395604395
"Chr08","427642","A","G",46,82,128,160,77,85,162,160,0.524691358024691,0.640625,0.424137931034483,-0.115933641975309
"Chr08","427687","A","G",51,80,131,143,85,69,154,143,0.448051948051948,0.610687022900763,0.47719298245614,-0.162635074848815
"Chr08","449939","C","T",40,34,74,147,28,37,65,147,0.569230769230769,0.459459459459459,0.489208633093525,0.10977130977131
"Chr08","450587","A","C",38,75,113,160,60,51,111,160,0.459459459459459,0.663716814159292,0.4375,-0.204257354699833
"Chr08","450643","A","T",63,102,165,160,76,75,151,160,0.496688741721854,0.618181818181818,0.439873417721519,-0.121493076459964
"Chr08","450727","G","A",40,45,85,160,41,46,87,160,0.528735632183908,0.529411764705882,0.47093023255814,-0.000676132521974293
"Chr08","450913","A","T",59,54,113,160,78,54,132,160,0.409090909090909,0.47787610619469,0.559183673469388,-0.0687851971037812
"Chr08","450963","C","A",55,89,144,160,81,71,152,160,0.467105263157895,0.618055555555556,0.459459459459459,-0.150950292397661
"Chr08","450977","G","A",56,87,143,160,78,70,148,160,0.472972972972973,0.608391608391608,0.460481099656357,-0.135418635418635
"Chr08","450986","C","T",55,88,143,160,78,69,147,160,0.469387755102041,0.615384615384615,0.458620689655172,-0.145996860282575
"Chr08","451069","T","C",53,61,114,139,70,58,128,139,0.453125,0.535087719298246,0.508264462809917,-0.0819627192982456
"Chr08","451107","G","A",44,52,96,160,50,56,106,160,0.528301886792453,0.541666666666667,0.465346534653465,-0.0133647798742138
"Chr08","451141","A","G",41,50,91,145,47,54,101,145,0.534653465346535,0.549450549450549,0.458333333333333,-0.0147970841040148
"Chr08","451197","G","A",31,47,78,160,41,50,91,160,0.549450549450549,0.602564102564103,0.42603550295858,-0.053113553113553
"Chr08","451412","T","C",43,45,88,142,55,52,107,142,0.485981308411215,0.511363636363636,0.502564102564103,-0.0253823279524214
"Chr08","451436","A","G",48,46,94,152,54,59,113,152,0.52212389380531,0.48936170212766,0.492753623188406,0.0327621916776502
"Chr08","451468","G","A",47,43,90,160,44,51,95,160,0.536842105263158,0.477777777777778,0.491891891891892,0.0590643274853801
"Chr08","451497","A","G",45,51,96,143,39,48,87,143,0.551724137931034,0.53125,0.459016393442623,0.0204741379310345
"Chr08","452077","A","G",32,53,85,160,64,54,118,160,0.457627118644068,0.623529411764706,0.472906403940887,-0.165902293120638
"Chr08","452437","A","G",30,53,83,153,35,46,81,153,0.567901234567901,0.63855421686747,0.396341463414634,-0.0706529822995686
"Chr08","458266","C","T",60,80,140,160,77,80,157,160,0.509554140127389,0.571428571428571,0.461279461279461,-0.0618744313011829
"Chr08","458602","T","C",38,61,99,160,49,65,114,160,0.570175438596491,0.616161616161616,0.408450704225352,-0.0459861775651249
"Chr08","459944","C","T",47,71,118,160,58,84,142,160,0.591549295774648,0.601694915254237,0.403846153846154,-0.0101456194795894
"Chr08","460274","T","C",62,110,172,160,101,111,212,160,0.523584905660377,0.63953488372093,0.424479166666667,-0.115949978060553
"Chr08","462629","G","A",30,87,117,160,66,66,132,160,0.5,0.743589743589744,0.385542168674699,-0.243589743589744
"Chr08","462711","A","G",34,81,115,160,64,64,128,160,0.5,0.704347826086957,0.403292181069959,-0.204347826086957
"Chr08","462965","A","G",44,97,141,160,64,77,141,160,0.546099290780142,0.687943262411348,0.382978723404255,-0.141843971631206
"Chr08","462973","A","G",46,97,143,140,63,76,139,140,0.546762589928058,0.678321678321678,0.386524822695035,-0.131559088393621
"Chr08","462990","G","A",43,93,136,139,69,80,149,139,0.536912751677852,0.683823529411765,0.392982456140351,-0.146910777733912
"Chr08","463033","A","C",54,85,139,141,71,80,151,141,0.529801324503311,0.611510791366906,0.431034482758621,-0.0817094668635951
"Chr08","463061","C","A",64,88,152,151,75,82,157,151,0.522292993630573,0.578947368421053,0.449838187702265,-0.0566543747904794
"Chr08","463105","C","T",59,86,145,160,80,76,156,160,0.487179487179487,0.593103448275862,0.461794019933555,-0.105923961096375
"Chr08","463112","A","G",62,83,145,160,80,77,157,160,0.490445859872611,0.572413793103448,0.470198675496689,-0.0819679332308368
"Chr08","463127","A","G",63,92,155,141,88,79,167,141,0.473053892215569,0.593548387096774,0.468944099378882,-0.120494494881205
"Chr08","464315","T","A",76,119,195,160,99,124,223,160,0.556053811659193,0.61025641025641,0.41866028708134,-0.0542025985972174
"Chr08","464802","A","G",82,113,195,159,89,109,198,159,0.55050505050505,0.57948717948718,0.435114503816794,-0.028982128982129
"Chr08","464936","T","C",55,82,137,144,71,76,147,144,0.517006802721088,0.598540145985402,0.443661971830986,-0.0815333432643131
"Chr08","465049","G","T",81,118,199,160,88,86,174,160,0.494252873563218,0.592964824120603,0.453083109919571,-0.0987119505573846
"Chr08","465063","T","G",85,116,201,140,91,87,178,140,0.48876404494382,0.577114427860697,0.464379947229551,-0.0883503829168764
"Chr08","465321","C","T",38,66,104,142,58,48,106,142,0.452830188679245,0.634615384615385,0.457142857142857,-0.181785195936139
"Chr08","465689","T","C",57,79,136,140,83,72,155,140,0.464516129032258,0.580882352941177,0.481099656357388,-0.116366223908918
"Chr08","465755","G","T",55,62,117,160,68,71,139,160,0.510791366906475,0.52991452991453,0.48046875,-0.0191231630080551
"Chr08","466626","C","G",47,92,139,138,78,71,149,138,0.476510067114094,0.661870503597122,0.434027777777778,-0.185360436483028
"Chr08","467979","C","T",65,94,159,160,90,90,180,160,0.5,0.591194968553459,0.457227138643068,-0.0911949685534591
"Chr08","468170","A","C",80,115,195,139,120,88,208,139,0.423076923076923,0.58974358974359,0.496277915632754,-0.166666666666667
"Chr08","468427","C","T",41,69,110,160,84,56,140,160,0.4,0.627272727272727,0.5,-0.227272727272727
"Chr08","468952","A","G",46,48,94,160,66,51,117,160,0.435897435897436,0.51063829787234,0.530805687203792,-0.0747408619749045
"Chr08","469132","C","T",23,24,47,160,28,28,56,160,0.5,0.51063829787234,0.495145631067961,-0.0106382978723404
"Chr08","469392","G","A",18,13,31,142,15,24,39,142,0.615384615384615,0.419354838709677,0.471428571428571,0.196029776674938
"Chr08","469897","C","T",7,6,13,108,14,16,30,144,0.533333333333333,0.461538461538462,0.488372093023256,0.0717948717948718
"Chr08","472240","C","T",71,86,157,160,101,97,198,160,0.48989898989899,0.547770700636943,0.484507042253521,-0.0578717107379528
"Chr08","472316","A","G",35,60,95,160,38,54,92,160,0.58695652173913,0.631578947368421,0.390374331550802,-0.0446224256292905
"Chr08","473707","C","A",41,80,121,143,93,92,185,143,0.497297297297297,0.661157024793388,0.437908496732026,-0.163859727496091
"Chr08","475208","C","G",62,91,153,160,82,101,183,160,0.551912568306011,0.594771241830065,0.428571428571429,-0.0428586735240545
"Chr08","475225","G","A",49,81,130,160,65,77,142,160,0.542253521126761,0.623076923076923,0.419117647058824,-0.0808234019501625
"Chr08","475315","C","T",30,81,111,142,72,78,150,142,0.52,0.72972972972973,0.390804597701149,-0.20972972972973
"Chr08","475340","G","A",24,76,100,139,64,67,131,139,0.511450381679389,0.76,0.380952380952381,-0.248549618320611
"Chr08","475353","A","T",22,67,89,139,66,59,125,139,0.472,0.752808988764045,0.411214953271028,-0.280808988764045
"Chr08","475373","A","G",24,60,84,151,57,65,122,151,0.532786885245902,0.714285714285714,0.393203883495146,-0.181498829039813
"Chr08","475385","G","A",27,63,90,140,53,64,117,140,0.547008547008547,0.7,0.386473429951691,-0.152991452991453
"Chr08","477877","T","A",39,46,85,160,55,49,104,160,0.471153846153846,0.541176470588235,0.497354497354497,-0.0700226244343891
"Chr08","481146","T","C",59,37,96,139,82,52,134,139,0.388059701492537,0.385416666666667,0.61304347826087,0.00264303482587064
"Chr08","481315","C","T",43,63,106,160,81,54,135,160,0.4,0.594339622641509,0.514522821576763,-0.194339622641509
"Chr08","481645","G","T",56,65,121,139,86,71,157,139,0.452229299363057,0.537190082644628,0.510791366906475,-0.0849607832815708
"Chr08","482962","G","A",57,67,124,160,74,60,134,160,0.447761194029851,0.540322580645161,0.507751937984496,-0.0925613866153105
"Chr08","483309","T","C",71,86,157,160,78,85,163,160,0.521472392638037,0.547770700636943,0.465625,-0.0262983079989059
"Chr08","484443","T","G",74,84,158,160,90,89,179,160,0.497206703910615,0.531645569620253,0.486646884272997,-0.0344388657096386
"Chr08","485496","G","A",46,76,122,160,70,62,132,160,0.46969696969697,0.622950819672131,0.456692913385827,-0.153253849975161
"Chr08","486506","G","A",25,24,49,145,35,28,63,145,0.444444444444444,0.489795918367347,0.535714285714286,-0.0453514739229025
"Chr08","486899","T","C",25,40,65,160,16,41,57,160,0.719298245614035,0.615384615384615,0.336065573770492,0.10391363022942
"Chr08","487375","G","A",50,32,82,142,77,47,124,142,0.379032258064516,0.390243902439024,0.616504854368932,-0.0112116443745083
"Chr08","487536","G","C",31,44,75,147,60,44,104,147,0.423076923076923,0.586666666666667,0.508379888268156,-0.163589743589744
"Chr08","487542","T","C",31,43,74,160,63,43,106,160,0.405660377358491,0.581081081081081,0.522222222222222,-0.17542070372259
"Chr08","489024","G","C",51,76,127,160,73,66,139,160,0.474820143884892,0.598425196850394,0.466165413533835,-0.123605052965502
"Chr08","490158","C","T",43,57,100,147,77,58,135,147,0.42962962962963,0.57,0.51063829787234,-0.14037037037037
"Chr08","490732","G","A",56,70,126,140,117,97,214,140,0.453271028037383,0.555555555555556,0.508823529411765,-0.102284527518172
"Chr08","491401","G","A",62,71,133,160,78,101,179,160,0.564245810055866,0.533834586466165,0.448717948717949,0.0304112235897005
"Chr08","492257","C","T",34,75,109,140,51,60,111,140,0.540540540540541,0.688073394495413,0.386363636363636,-0.147532853954872
"Chr08","492264","C","T",36,74,110,156,47,60,107,156,0.560747663551402,0.672727272727273,0.382488479262673,-0.111979609175871
"Chr08","492308","C","T",39,78,117,160,50,63,113,160,0.557522123893805,0.666666666666667,0.38695652173913,-0.109144542772861
"Chr08","492587","G","T",10,13,23,142,12,19,31,142,0.612903225806452,0.565217391304348,0.407407407407407,0.0476858345021038
"Chr08","492618","A","G",7,11,18,127,14,20,34,152,0.588235294117647,0.611111111111111,0.403846153846154,-0.0228758169934641
"Chr08","493601","A","C",31,39,70,141,53,56,109,141,0.513761467889908,0.557142857142857,0.46927374301676,-0.0433813892529489
"Chr08","493739","G","T",54,65,119,160,101,81,182,160,0.445054945054945,0.546218487394958,0.514950166112957,-0.101163542340013
"Chr08","493754","C","G",51,73,124,136,102,85,187,136,0.454545454545455,0.588709677419355,0.491961414790997,-0.1341642228739
"Chr08","493792","G","C",51,86,137,160,95,69,164,160,0.420731707317073,0.627737226277372,0.485049833887043,-0.207005518960299
"Chr08","494134","G","A",62,82,144,160,96,89,185,160,0.481081081081081,0.569444444444444,0.480243161094225,-0.0883633633633633
"Chr08","494306","T","G",36,87,123,160,89,77,166,160,0.463855421686747,0.707317073170732,0.432525951557093,-0.243461651483985
"Chr08","495373","T","A",47,64,111,140,62,62,124,140,0.5,0.576576576576577,0.463829787234043,-0.0765765765765766
"Chr08","497119","C","T",46,51,97,145,78,76,154,145,0.493506493506494,0.525773195876289,0.49402390438247,-0.0322667023697952
"Chr08","497931","G","A",45,96,141,136,61,83,144,136,0.576388888888889,0.680851063829787,0.371929824561403,-0.104462174940898
"Chr08","501142","T","A",31,42,73,144,34,37,71,144,0.52112676056338,0.575342465753425,0.451388888888889,-0.0542157051900444
"Chr08","501164","C","G",32,57,89,138,33,39,72,138,0.541666666666667,0.640449438202247,0.403726708074534,-0.0987827715355806
"Chr08","501402","T","G",28,69,97,160,74,58,132,160,0.439393939393939,0.711340206185567,0.445414847161572,-0.271946266791628
"Chr08","501599","G","A",33,54,87,160,49,55,104,160,0.528846153846154,0.620689655172414,0.429319371727749,-0.09184350132626
"Chr08","501647","G","A",24,33,57,140,49,61,110,140,0.554545454545455,0.578947368421053,0.437125748502994,-0.0244019138755981
"Chr08","501686","T","A",16,19,35,160,27,40,67,160,0.597014925373134,0.542857142857143,0.42156862745098,0.0541577825159915
"Chr08","503824","A","G",52,65,117,140,83,73,156,140,0.467948717948718,0.555555555555556,0.494505494505495,-0.0876068376068376
"Chr08","504603","G","C",19,24,43,160,21,21,42,160,0.5,0.558139534883721,0.470588235294118,-0.0581395348837209
"Chr08","509785","T","C",87,61,148,138,86,74,160,138,0.4625,0.412162162162162,0.561688311688312,0.0503378378378379
"Chr08","509824","C","T",71,56,127,142,69,70,139,142,0.503597122302158,0.440944881889764,0.526315789473684,0.0626522404123945
"Chr08","509831","G","A",73,51,124,141,68,70,138,141,0.507246376811594,0.411290322580645,0.538167938931298,0.0959560542309491
"Chr08","509904","G","C",70,54,124,145,74,88,162,145,0.54320987654321,0.435483870967742,0.503496503496504,0.107726005575468
"Chr08","509921","T","A",61,54,115,160,80,82,162,160,0.506172839506173,0.469565217391304,0.509025270758123,0.0366076221148685
"Chr08","510003","A","G",61,57,118,160,55,75,130,160,0.576923076923077,0.483050847457627,0.467741935483871,0.0938722294654498
"Chr08","510010","A","G",77,60,137,136,63,83,146,136,0.568493150684932,0.437956204379562,0.49469964664311,0.130536946305369
"Chr08","510692","T","C",41,16,57,160,43,45,88,160,0.511363636363636,0.280701754385965,0.579310344827586,0.230661881977671
"Chr08","510775","C","T",30,19,49,160,52,44,96,160,0.458333333333333,0.387755102040816,0.56551724137931,0.070578231292517
"Chr08","511007","G","A",51,47,98,140,60,67,127,140,0.52755905511811,0.479591836734694,0.493333333333333,0.0479672183834163
"Chr08","511482","C","T",82,63,145,160,105,99,204,160,0.485294117647059,0.43448275862069,0.535816618911175,0.0508113590263692
"Chr08","511513","T","G",62,59,121,160,85,99,184,160,0.53804347826087,0.487603305785124,0.481967213114754,0.0504401724757456
"Chr08","511763","T","G",106,57,163,136,102,96,198,136,0.484848484848485,0.349693251533742,0.57617728531856,0.135155233314743
"Chr08","511812","T","G",103,65,168,160,102,98,200,160,0.49,0.386904761904762,0.557065217391304,0.103095238095238
"Chr08","511829","G","A",93,71,164,160,92,97,189,160,0.513227513227513,0.432926829268293,0.524079320113314,0.0803006839592206
"Chr08","511838","G","C",78,70,148,160,87,89,176,160,0.505681818181818,0.472972972972973,0.509259259259259,0.0327088452088453
"Chr08","511853","C","A",76,65,141,160,72,99,171,160,0.578947368421053,0.460992907801418,0.474358974358974,0.117954460619634
"Chr08","511859","G","A",76,64,140,142,69,96,165,142,0.581818181818182,0.457142857142857,0.475409836065574,0.124675324675325
"Chr08","511914","C","T",103,79,182,137,90,134,224,137,0.598214285714286,0.434065934065934,0.475369458128079,0.164148351648352
"Chr08","511947","T","G",110,78,188,160,98,140,238,160,0.588235294117647,0.414893617021277,0.488262910798122,0.17334167709637
"Chr08","511954","A","T",113,74,187,143,92,137,229,143,0.59825327510917,0.39572192513369,0.492788461538462,0.20253134997548
"Chr08","511978","T","G",107,64,171,137,88,127,215,137,0.590697674418605,0.374269005847953,0.505181347150259,0.216428668570651
"Chr08","512018","A","G",100,71,171,141,92,119,211,141,0.563981042654028,0.415204678362573,0.50261780104712,0.148776364291455
"Chr08","512032","T","A",103,82,185,136,86,125,211,136,0.592417061611374,0.443243243243243,0.477272727272727,0.149173818368131
"Chr08","512059","A","G",89,58,147,160,75,86,161,160,0.53416149068323,0.394557823129252,0.532467532467532,0.139603667553978
"Chr08","512068","T","C",84,56,140,143,74,81,155,143,0.52258064516129,0.4,0.535593220338983,0.12258064516129
"Chr08","512079","G","A",85,53,138,139,72,77,149,139,0.516778523489933,0.384057971014493,0.547038327526132,0.13272055247544
"Chr08","512515","T","G",70,49,119,142,95,75,170,142,0.441176470588235,0.411764705882353,0.570934256055363,0.0294117647058824
"Chr08","512553","A","G",70,51,121,160,101,61,162,160,0.376543209876543,0.421487603305785,0.604240282685512,-0.0449443934292419
"Chr08","512661","T","C",87,56,143,160,88,99,187,160,0.529411764705882,0.391608391608392,0.53030303030303,0.137803373097491
"Chr08","512680","T","C",81,61,142,138,84,104,188,138,0.553191489361702,0.429577464788732,0.5,0.12361402457297
"Chr08","512724","A","T",77,53,130,137,82,114,196,137,0.581632653061224,0.407692307692308,0.487730061349693,0.173940345368917
"Chr08","512747","G","A",53,73,126,141,97,81,178,141,0.455056179775281,0.579365079365079,0.493421052631579,-0.124308899589799
"Chr08","512806","G","C",69,46,115,139,70,85,155,139,0.548387096774194,0.4,0.514814814814815,0.148387096774193
"Chr08","512862","A","C",77,60,137,138,99,92,191,138,0.481675392670157,0.437956204379562,0.536585365853659,0.043719188290595
"Chr08","513063","T","A",78,64,142,138,87,97,184,138,0.527173913043478,0.450704225352113,0.506134969325153,0.0764696876913656
"Chr08","513144","G","A",56,42,98,140,50,63,113,140,0.557522123893805,0.428571428571429,0.502369668246445,0.128950695322377
"Chr08","513205","A","G",72,41,113,160,50,89,139,160,0.640287769784173,0.36283185840708,0.484126984126984,0.277455911377093
"Chr08","513254","G","A",47,24,71,143,46,52,98,143,0.530612244897959,0.338028169014085,0.550295857988166,0.192584075883875
"Chr08","513269","C","G",47,21,68,160,49,51,100,160,0.51,0.308823529411765,0.571428571428571,0.201176470588235
"Chr08","513433","T","C",45,17,62,160,30,39,69,160,0.565217391304348,0.274193548387097,0.572519083969466,0.291023842917251
"Chr08","513445","T","C",46,17,63,149,31,37,68,149,0.544117647058823,0.26984126984127,0.587786259541985,0.274276377217554
"Chr08","514274","T","A",59,41,100,160,63,57,120,160,0.475,0.41,0.554545454545455,0.065
"Chr08","514480","G","A",73,58,131,141,91,80,171,141,0.467836257309941,0.442748091603053,0.543046357615894,0.025088165706888
"Chr08","514944","T","A",85,63,148,136,106,95,201,136,0.472636815920398,0.425675675675676,0.547277936962751,0.0469611402447224
"Chr08","514988","C","A",96,72,168,147,115,112,227,147,0.493392070484582,0.428571428571429,0.534177215189873,0.064820641913153
"Chr08","515481","G","A",115,71,186,160,84,105,189,160,0.555555555555556,0.381720430107527,0.530666666666667,0.173835125448029
"Chr08","516351","T","A",76,40,116,144,62,83,145,144,0.572413793103448,0.344827586206897,0.528735632183908,0.227586206896552
"Chr08","516508","C","T",90,57,147,160,86,83,169,160,0.49112426035503,0.387755102040816,0.556962025316456,0.103369158314213
"Chr08","516680","G","A",115,66,181,160,104,122,226,160,0.539823008849557,0.364640883977901,0.538083538083538,0.175182124871657
"Chr08","516768","C","T",85,46,131,160,58,70,128,160,0.546875,0.351145038167939,0.552123552123552,0.195729961832061
"Chr08","516800","T","C",73,54,127,160,49,72,121,160,0.59504132231405,0.425196850393701,0.491935483870968,0.169844471920349
"Chr08","516869","T","C",83,62,145,150,70,91,161,150,0.565217391304348,0.427586206896552,0.5,0.137631184407796
"Chr08","516876","G","C",80,58,138,136,71,88,159,136,0.553459119496855,0.420289855072464,0.508417508417508,0.133169264424392
"Chr08","516889","G","A",77,57,134,160,84,88,172,160,0.511627906976744,0.425373134328358,0.526143790849673,0.086254772648386
"Chr08","516951","A","G",84,48,132,136,78,85,163,136,0.521472392638037,0.363636363636364,0.549152542372881,0.157836029001673
"Chr08","516989","G","A",81,51,132,144,75,77,152,144,0.506578947368421,0.386363636363636,0.549295774647887,0.120215311004785
"Chr08","517016","C","T",82,55,137,143,73,74,147,143,0.503401360544218,0.401459854014599,0.545774647887324,0.101941506529619
"Chr08","517048","G","A",101,69,170,143,88,117,205,143,0.570731707317073,0.405882352941176,0.504,0.164849354375897
"Chr08","517102","G","T",101,65,166,139,78,112,190,139,0.589473684210526,0.391566265060241,0.502808988764045,0.197907419150285
"Chr08","517132","C","T",94,62,156,160,79,100,179,160,0.558659217877095,0.397435897435897,0.516417910447761,0.161223320441198
"Chr08","517141","C","A",92,55,147,160,77,88,165,160,0.533333333333333,0.374149659863946,0.541666666666667,0.159183673469388
"Chr08","517163","G","C",83,61,144,160,74,85,159,160,0.534591194968553,0.423611111111111,0.518151815181518,0.110980083857442
"Chr08","517392","G","A",53,30,83,160,46,49,95,160,0.515789473684211,0.36144578313253,0.556179775280899,0.15434369055168
"Chr08","517719","C","G",43,39,82,160,49,62,111,160,0.558558558558559,0.475609756097561,0.476683937823834,0.0829488024609976
"Chr08","517827","C","T",51,37,88,160,59,41,100,160,0.41,0.420454545454545,0.585106382978723,-0.0104545454545455
"Chr08","517914","G","C",59,52,111,160,63,56,119,160,0.470588235294118,0.468468468468468,0.530434782608696,0.00211976682564918
"Chr08","517946","T","G",50,45,95,142,55,55,110,142,0.5,0.473684210526316,0.51219512195122,0.0263157894736842
"Chr08","518132","G","T",44,37,81,160,49,52,101,160,0.514851485148515,0.45679012345679,0.510989010989011,0.0580613616917248
"Chr08","518160","G","A",49,32,81,160,52,47,99,160,0.474747474747475,0.395061728395062,0.561111111111111,0.079685746352413
"Chr08","518182","A","G",49,45,94,160,67,61,128,160,0.4765625,0.478723404255319,0.522522522522523,-0.00216090425531917
"Chr08","518212","C","T",36,38,74,148,64,61,125,148,0.488,0.513513513513513,0.50251256281407,-0.0255135135135135
"Chr08","518289","G","T",47,63,110,142,66,108,174,142,0.620689655172414,0.572727272727273,0.397887323943662,0.0479623824451411
"Chr08","518309","T","C",43,65,108,146,67,104,171,146,0.608187134502924,0.601851851851852,0.39426523297491,0.00633528265107208
"Chr08","518331","T","G",48,61,109,141,52,94,146,141,0.643835616438356,0.559633027522936,0.392156862745098,0.0842025889154204
"Chr08","518348","T","A",49,46,95,160,47,78,125,160,0.624,0.484210526315789,0.436363636363636,0.139789473684211
"Chr08","518442","G","A",82,72,154,160,102,114,216,160,0.527777777777778,0.467532467532468,0.497297297297297,0.0602453102453103
"Chr08","518464","A","G",101,61,162,136,118,109,227,136,0.480176211453745,0.376543209876543,0.562982005141388,0.103633001577201
"Chr08","518481","C","A",98,58,156,160,122,109,231,160,0.471861471861472,0.371794871794872,0.568475452196382,0.1000666000666
"Chr08","518512","G","A",110,63,173,140,132,121,253,140,0.478260869565217,0.364161849710983,0.568075117370892,0.114099019854235
"Chr08","518527","A","G",121,67,188,144,128,122,250,144,0.488,0.356382978723404,0.568493150684932,0.131617021276596
"Chr08","518556","A","G",126,57,183,160,132,104,236,160,0.440677966101695,0.311475409836066,0.615751789976134,0.129202556265629
"Chr08","518701","C","T",70,46,116,160,85,77,162,160,0.475308641975309,0.396551724137931,0.557553956834532,0.0787569178373776
"Chr08","518759","G","A",97,64,161,160,95,100,195,160,0.512820512820513,0.397515527950311,0.539325842696629,0.115304984870202
"Chr08","518801","A","C",99,60,159,160,97,82,179,160,0.458100558659218,0.377358490566038,0.579881656804734,0.0807420680931801
"Chr08","518851","A","G",136,81,217,160,128,115,243,160,0.473251028806584,0.373271889400922,0.573913043478261,0.0999791394056627
"Chr08","519413","T","G",100,76,176,160,109,134,243,160,0.551440329218107,0.431818181818182,0.498806682577566,0.119622147399925
"Chr08","519419","C","T",96,79,175,153,103,139,242,153,0.574380165289256,0.451428571428571,0.477218225419664,0.122951593860685
"Chr08","519433","C","T",85,65,150,136,89,124,213,136,0.582159624413146,0.433333333333333,0.479338842975207,0.148826291079812
"Chr08","519454","A","C",91,70,161,160,102,127,229,160,0.554585152838428,0.434782608695652,0.494871794871795,0.119802544142776
"Chr08","519476","G","A",83,63,146,138,80,127,207,138,0.613526570048309,0.431506849315068,0.461756373937677,0.182019720733241
"Chr08","519486","G","A",96,62,158,140,81,120,201,140,0.597014925373134,0.392405063291139,0.493036211699164,0.204609862081995
"Chr08","519596","A","G",117,63,180,160,108,103,211,160,0.488151658767773,0.35,0.575447570332481,0.138151658767773
"Chr08","519605","A","T",117,57,174,160,98,96,194,160,0.494845360824742,0.327586206896552,0.584239130434783,0.167259153928191
"Chr08","519611","T","G",110,54,164,160,100,90,190,160,0.473684210526316,0.329268292682927,0.593220338983051,0.144415917843389
"Chr08","519653","A","G",87,52,139,139,85,85,170,139,0.5,0.37410071942446,0.55663430420712,0.12589928057554
"Chr08","519658","C","T",52,88,140,139,85,86,171,139,0.502923976608187,0.628571428571429,0.440514469453376,-0.125647451963241
"Chr08","519692","G","T",88,51,139,160,89,96,185,160,0.518918918918919,0.366906474820144,0.546296296296296,0.152012444098775
"Chr08","519731","C","T",87,63,150,142,83,112,195,142,0.574358974358974,0.42,0.492753623188406,0.154358974358974
"Chr08","519856","A","C",92,61,153,138,97,96,193,138,0.49740932642487,0.398692810457516,0.546242774566474,0.0987165159673541
"Chr08","521140","A","G",53,41,94,139,56,49,105,139,0.466666666666667,0.436170212765957,0.547738693467337,0.0304964539007092
"Chr08","521148","C","T",50,40,90,145,53,50,103,145,0.485436893203884,0.444444444444444,0.533678756476684,0.0409924487594391
"Chr08","521174","A","G",52,44,96,147,60,58,118,147,0.491525423728814,0.458333333333333,0.523364485981308,0.0331920903954803
"Chr08","522274","T","C",12,11,23,152,36,23,59,152,0.389830508474576,0.478260869565217,0.585365853658537,-0.0884303610906411
"Chr08","522426","A","G",29,16,45,160,24,32,56,160,0.571428571428571,0.355555555555556,0.524752475247525,0.215873015873016
"Chr08","523086","A","G",75,36,111,160,67,71,138,160,0.514492753623188,0.324324324324324,0.570281124497992,0.190168429298864
"Chr08","524030","A","G",88,38,126,160,73,69,142,160,0.485915492957746,0.301587301587302,0.600746268656716,0.184328191370445
"Chr08","524349","G","C",87,48,135,160,88,91,179,160,0.508379888268156,0.355555555555556,0.557324840764331,0.152824332712601
"Chr08","526456","T","C",50,33,83,159,83,58,141,159,0.411347517730496,0.397590361445783,0.59375,0.0137571562847133
"Chr08","526486","C","A",56,41,97,160,85,73,158,160,0.462025316455696,0.422680412371134,0.552941176470588,0.0393449040845622
"Chr08","526649","C","G",35,30,65,160,42,38,80,160,0.475,0.461538461538462,0.531034482758621,0.0134615384615384
"Chr08","526880","T","C",41,28,69,142,60,46,106,142,0.433962264150943,0.405797101449275,0.577142857142857,0.028165162701668
"Chr08","526891","A","G",25,16,41,160,42,36,78,160,0.461538461538462,0.390243902439024,0.563025210084034,0.0712945590994372
"Chr08","527041","A","C",96,53,149,134,121,70,191,134,0.366492146596859,0.355704697986577,0.638235294117647,0.0107874486102815
"Chr08","527484","C","A",109,71,180,137,118,93,211,137,0.440758293838863,0.394444444444444,0.580562659846547,0.0463138493944181
"Chr08","528187","C","T",61,41,102,143,46,54,100,143,0.54,0.401960784313726,0.52970297029703,0.138039215686275
"Chr08","528199","C","A",56,40,96,146,49,42,91,146,0.461538461538462,0.416666666666667,0.561497326203209,0.0448717948717949
"Chr08","528442","A","T",39,36,75,148,41,52,93,148,0.559139784946237,0.48,0.476190476190476,0.0791397849462365
"Chr08","528790","T","C",20,34,54,160,31,58,89,160,0.651685393258427,0.62962962962963,0.356643356643357,0.0220557636287974
"Chr08","528829","C","T",22,40,62,160,26,49,75,160,0.653333333333333,0.645161290322581,0.35036496350365,0.00817204301075269
"Chr08","536812","G","C",66,49,115,139,75,58,133,139,0.43609022556391,0.426086956521739,0.568548387096774,0.0100032690421706
"Chr08","537045","C","T",88,60,148,139,95,81,176,139,0.460227272727273,0.405405405405405,0.564814814814815,0.0548218673218673
"Chr08","537156","A","C",70,66,136,160,77,96,173,160,0.554913294797688,0.485294117647059,0.475728155339806,0.069619177150629
"Chr08","537181","G","A",68,55,123,160,63,87,150,160,0.58,0.447154471544715,0.47985347985348,0.132845528455285
"Chr08","551542","C","A",39,27,66,141,34,52,86,141,0.604651162790698,0.409090909090909,0.480263157894737,0.195560253699789
"Chr08","552111","G","A",68,30,98,137,72,48,120,137,0.4,0.306122448979592,0.642201834862385,0.0938775510204082
"Chr08","552451","C","G",66,51,117,149,71,91,162,149,0.561728395061728,0.435897435897436,0.491039426523298,0.125830959164293
"Chr08","552571","C","A",82,49,131,137,90,85,175,137,0.485714285714286,0.374045801526718,0.562091503267974,0.111668484187568
"Chr08","552841","A","G",74,38,112,160,79,86,165,160,0.521212121212121,0.339285714285714,0.552346570397112,0.181926406926407
"Chr08","553037","G","T",39,67,106,154,67,73,140,154,0.521428571428571,0.632075471698113,0.430894308943089,-0.110646900269542
"Chr08","553287","T","C",57,45,102,143,47,66,113,143,0.584070796460177,0.441176470588235,0.483720930232558,0.142894325871942
"Chr08","553311","A","G",47,62,109,141,68,55,123,141,0.447154471544715,0.568807339449541,0.495689655172414,-0.121652867904826
"Chr08","553386","T","A",61,31,92,142,45,52,97,142,0.536082474226804,0.33695652173913,0.560846560846561,0.199125952487674
"Chr08","553513","G","A",34,63,97,160,63,67,130,160,0.515384615384615,0.649484536082474,0.427312775330396,-0.134099920697859
"Chr08","553573","G","T",66,36,102,139,63,52,115,139,0.452173913043478,0.352941176470588,0.594470046082949,0.09923273657289
"Chr08","553587","C","T",60,37,97,142,59,54,113,142,0.47787610619469,0.381443298969072,0.566666666666667,0.0964328072256181
"Chr08","553807","T","C",50,37,87,160,69,52,121,160,0.429752066115702,0.425287356321839,0.572115384615385,0.00446470979386343
"Chr08","553867","C","T",37,35,72,160,61,49,110,160,0.445454545454545,0.486111111111111,0.538461538461538,-0.0406565656565657
"Chr08","553906","T","A",74,39,113,160,78,65,143,160,0.454545454545455,0.345132743362832,0.59375,0.109412711182623
"Chr08","554164","A","T",47,61,108,160,57,74,131,160,0.564885496183206,0.564814814814815,0.435146443514644,7.06813683913898e-05
"Chr08","554194","T","G",29,23,52,160,28,36,64,160,0.5625,0.442307692307692,0.491379310344828,0.120192307692308
"Chr08","554316","A","G",35,41,76,144,50,43,93,144,0.462365591397849,0.539473684210526,0.502958579881657,-0.0771080928126769
"Chr08","554475","G","C",30,40,70,141,41,48,89,141,0.539325842696629,0.571428571428571,0.446540880503145,-0.0321027287319422
"Chr08","554527","G","T",35,35,70,160,38,46,84,160,0.547619047619048,0.5,0.474025974025974,0.0476190476190477
"Chr08","554532","A","G",35,35,70,140,39,46,85,140,0.541176470588235,0.5,0.47741935483871,0.0411764705882353
"Chr08","554556","C","A",38,46,84,160,47,54,101,160,0.534653465346535,0.547619047619048,0.459459459459459,-0.012965582272513
"Chr08","554588","G","T",30,35,65,160,40,50,90,160,0.555555555555556,0.538461538461538,0.451612903225806,0.0170940170940171
"Chr08","554597","C","T",27,31,58,160,45,54,99,160,0.545454545454545,0.53448275862069,0.45859872611465,0.0109717868338558
"Chr08","554661","C","T",19,26,45,140,37,43,80,140,0.5375,0.577777777777778,0.448,-0.0402777777777777
"Chr08","554709","G","A",24,22,46,160,50,47,97,160,0.484536082474227,0.478260869565217,0.517482517482518,0.0062752129090094
"Chr08","554763","C","T",25,27,52,160,37,54,91,160,0.593406593406593,0.519230769230769,0.433566433566434,0.0741758241758241
"Chr08","554855","C","T",19,26,45,160,42,33,75,160,0.44,0.577777777777778,0.508333333333333,-0.137777777777778
"Chr08","554904","G","A",32,18,50,140,45,49,94,140,0.521276595744681,0.36,0.534722222222222,0.161276595744681
"Chr08","554922","C","T",35,20,55,160,48,41,89,160,0.460674157303371,0.363636363636364,0.576388888888889,0.0970377936670072
"Chr08","554942","T","C",33,21,54,142,45,43,88,142,0.488636363636364,0.388888888888889,0.549295774647887,0.0997474747474748
"Chr08","557646","A","G",71,92,163,160,95,113,208,160,0.543269230769231,0.56441717791411,0.44743935309973,-0.0211479471448797
"Chr08","558045","A","T",120,66,186,136,124,79,203,136,0.389162561576355,0.354838709677419,0.627249357326478,0.0343238518989353
"Chr08","558050","G","C",66,132,198,160,93,137,230,160,0.595652173913043,0.666666666666667,0.371495327102804,-0.0710144927536231
"Chr08","558222","T","C",103,56,159,160,100,81,181,160,0.447513812154696,0.352201257861635,0.597058823529412,0.095312554293061
"Chr08","558229","G","A",102,57,159,142,98,83,181,142,0.458563535911602,0.358490566037736,0.588235294117647,0.100072969873866
"Chr08","558261","T","C",104,54,158,140,107,89,196,140,0.454081632653061,0.341772151898734,0.596045197740113,0.112309480754327
"Chr08","558487","T","C",74,108,182,138,109,95,204,138,0.465686274509804,0.593406593406593,0.474093264248705,-0.127720318896789
"Chr08","558987","T","A",80,56,136,136,89,106,195,136,0.543589743589744,0.411764705882353,0.510574018126888,0.131825037707391
"Chr08","559048","T","A",65,38,103,143,89,100,189,143,0.529100529100529,0.368932038834951,0.527397260273973,0.160168490265578
"Chr08","564120","A","C",78,50,128,160,79,81,160,160,0.50625,0.390625,0.545138888888889,0.115625
"Chr08","564318","T","C",95,67,162,160,106,106,212,160,0.5,0.41358024691358,0.537433155080214,0.0864197530864197
"Chr08","564489","T","C",112,69,181,138,106,103,209,138,0.492822966507177,0.38121546961326,0.558974358974359,0.111607496893917
"Chr08","564582","A","C",49,44,93,145,78,78,156,145,0.5,0.473118279569892,0.51004016064257,0.0268817204301075
"Chr08","564921","A","T",102,66,168,144,137,117,254,144,0.460629921259843,0.392857142857143,0.566350710900474,0.0677727784026997
"Chr08","565529","C","A",86,57,143,143,83,98,181,143,0.541436464088398,0.398601398601399,0.521604938271605,0.142835065486999
"Chr08","565543","C","T",90,55,145,136,87,100,187,136,0.53475935828877,0.379310344827586,0.533132530120482,0.155449013461184
"Chr08","565974","A","C",95,44,139,160,65,74,139,160,0.532374100719424,0.316546762589928,0.575539568345324,0.215827338129496
"Chr08","566004","A","G",96,40,136,160,67,74,141,160,0.524822695035461,0.294117647058824,0.588447653429603,0.230705047976637
"Chr08","566016","C","T",88,39,127,160,59,74,133,160,0.556390977443609,0.307086614173228,0.565384615384615,0.249304363270381
"Chr08","566246","G","T",87,53,140,139,95,89,184,139,0.483695652173913,0.378571428571429,0.561728395061728,0.105124223602484
"Chr08","566590","G","A",88,55,143,153,95,93,188,153,0.49468085106383,0.384615384615385,0.552870090634441,0.110065466448445
"Chr08","566982","G","A",62,42,104,160,68,50,118,160,0.423728813559322,0.403846153846154,0.585585585585586,0.0198826597131682
"Chr08","566988","T","C",41,67,108,140,51,64,115,140,0.556521739130435,0.62037037037037,0.412556053811659,-0.0638486312399356
"Chr08","567709","C","T",72,51,123,143,63,60,123,143,0.48780487804878,0.414634146341463,0.548780487804878,0.0731707317073171
"Chr08","568286","G","A",81,56,137,160,85,69,154,160,0.448051948051948,0.408759124087591,0.570446735395189,0.0392928239643568
"Chr08","568558","C","T",46,29,75,139,38,45,83,139,0.542168674698795,0.386666666666667,0.531645569620253,0.155502008032128
"Chr08","569268","A","T",50,18,68,160,36,40,76,160,0.526315789473684,0.264705882352941,0.597222222222222,0.261609907120743
"Chr08","569303","G","A",47,17,64,160,39,35,74,160,0.472972972972973,0.265625,0.623188405797101,0.207347972972973
"Chr08","569360","G","A",52,21,73,160,57,40,97,160,0.412371134020619,0.287671232876712,0.641176470588235,0.124699901143906
"Chr08","569429","C","G",58,22,80,160,58,34,92,160,0.369565217391304,0.275,0.674418604651163,0.0945652173913043
"Chr08","569809","A","G",36,28,64,145,38,24,62,145,0.387096774193548,0.4375,0.587301587301587,-0.0504032258064516
"Chr08","570216","C","T",13,10,23,148,17,19,36,148,0.527777777777778,0.434782608695652,0.508474576271186,0.0929951690821256
"Chr08","570828","C","T",9,4,13,64,10,6,16,134,0.375,0.307692307692308,0.655172413793103,0.0673076923076923
"Chr08","570856","A","G",16,8,24,144,7,8,15,159,0.533333333333333,0.333333333333333,0.58974358974359,0.2
"Chr08","570864","T","C",16,8,24,141,5,8,13,128,0.615384615384615,0.333333333333333,0.567567567567568,0.282051282051282
"Chr08","571320","G","C",19,11,30,160,15,12,27,160,0.444444444444444,0.366666666666667,0.596491228070175,0.0777777777777778
"Chr08","571346","C","A",14,13,27,160,17,12,29,160,0.413793103448276,0.481481481481481,0.553571428571429,-0.0676883780332056
"Chr08","571452","A","T",7,5,12,127,15,13,28,160,0.464285714285714,0.416666666666667,0.55,0.0476190476190476
"Chr08","571709","T","C",10,12,22,144,17,21,38,144,0.552631578947368,0.545454545454545,0.45,0.00717703349282306
"Chr08","571719","C","G",14,14,28,146,19,21,40,146,0.525,0.5,0.485294117647059,0.025
"Chr08","571800","T","C",11,12,23,160,18,18,36,160,0.5,0.521739130434783,0.491525423728814,-0.0217391304347826
"Chr08","571836","G","T",12,15,27,160,23,20,43,160,0.465116279069767,0.555555555555556,0.5,-0.0904392764857881
"Chr08","571884","G","T",31,24,55,160,32,29,61,160,0.475409836065574,0.436363636363636,0.543103448275862,0.0390461997019374
"Chr08","571953","T","C",40,19,59,160,36,31,67,160,0.462686567164179,0.322033898305085,0.603174603174603,0.140652668859094
"Chr08","571965","C","T",39,22,61,160,35,30,65,160,0.461538461538462,0.360655737704918,0.587301587301587,0.100882723833544
"Chr08","571990","C","A",39,25,64,140,36,28,64,140,0.4375,0.390625,0.5859375,0.046875
"Chr08","572218","T","C",85,39,124,160,67,69,136,160,0.507352941176471,0.314516129032258,0.584615384615385,0.192836812144212
"Chr08","572319","C","T",58,46,104,160,64,70,134,160,0.522388059701492,0.442307692307692,0.512605042016807,0.0800803673938002
"Chr08","572324","A","G",55,46,101,142,63,68,131,142,0.519083969465649,0.455445544554455,0.508620689655172,0.0636384249111934
"Chr08","572336","C","T",62,48,110,139,72,67,139,139,0.482014388489209,0.436363636363636,0.538152610441767,0.0456507521255723
"Chr08","572373","G","T",64,55,119,160,80,79,159,160,0.49685534591195,0.46218487394958,0.517985611510791,0.0346704719623698
"Chr08","572634","A","T",68,50,118,160,76,87,163,160,0.533742331288344,0.423728813559322,0.512455516014235,0.110013517729022
"Chr08","572685","A","C",66,47,113,139,76,63,139,139,0.453237410071942,0.415929203539823,0.563492063492063,0.0373082065321195
"Chr08","572692","C","T",68,43,111,141,74,61,135,141,0.451851851851852,0.387387387387387,0.577235772357724,0.0644644644644645
"Chr08","573496","C","G",34,15,49,142,37,22,59,142,0.372881355932203,0.306122448979592,0.657407407407407,0.0667589069526116
"Chr08","573502","C","T",33,17,50,160,37,26,63,160,0.412698412698413,0.34,0.619469026548673,0.0726984126984127
"Chr08","573544","G","A",37,15,52,160,42,23,65,160,0.353846153846154,0.288461538461538,0.675213675213675,0.0653846153846154
"Chr08","573565","T","C",34,14,48,160,39,21,60,160,0.35,0.291666666666667,0.675925925925926,0.0583333333333333
"Chr08","573577","A","G",40,18,58,148,43,23,66,148,0.348484848484849,0.310344827586207,0.669354838709677,0.0381400208986416
"Chr08","573810","T","A",54,57,111,160,86,59,145,160,0.406896551724138,0.513513513513513,0.546875,-0.106616961789376
"Chr08","573892","G","C",65,60,125,160,83,76,159,160,0.477987421383648,0.48,0.52112676056338,-0.00201257861635218
"Chr08","574008","A","G",89,55,144,160,72,67,139,160,0.482014388489209,0.381944444444444,0.568904593639576,0.100069944044764
"Chr08","574017","A","G",83,53,136,160,75,67,142,160,0.471830985915493,0.389705882352941,0.568345323741007,0.0821251035625518
"Chr08","574023","A","G",83,49,132,143,75,68,143,143,0.475524475524476,0.371212121212121,0.574545454545455,0.104312354312354
"Chr08","574068","A","T",100,73,173,160,111,84,195,160,0.430769230769231,0.421965317919075,0.573369565217391,0.00880391285015564
"Chr08","574123","A","G",90,76,166,160,110,102,212,160,0.481132075471698,0.457831325301205,0.529100529100529,0.0233007501704933
"Chr08","574142","T","C",86,70,156,160,109,103,212,160,0.485849056603774,0.448717948717949,0.529891304347826,0.0371311078858249
"Chr08","574163","A","G",95,73,168,160,105,108,213,160,0.507042253521127,0.43452380952381,0.5249343832021,0.0725184439973172
"Chr08","575108","A","C",67,40,107,160,93,54,147,160,0.36734693877551,0.373831775700935,0.62992125984252,-0.00648483692542434
"Chr08","575173","C","G",66,27,93,139,77,52,129,139,0.403100775193798,0.290322580645161,0.644144144144144,0.112778194548637
"Chr08","575937","C","G",64,75,139,160,83,98,181,160,0.541436464088398,0.539568345323741,0.459375,0.00186811876465676
"Chr08","578365","A","G",82,69,151,160,79,71,150,160,0.473333333333333,0.456953642384106,0.534883720930233,0.0163796909492274
"Chr08","578866","A","C",83,59,142,144,111,110,221,144,0.497737556561086,0.415492957746479,0.534435261707989,0.0822445988146071
"Chr08","580011","A","C",60,42,102,160,64,73,137,160,0.532846715328467,0.411764705882353,0.518828451882845,0.121082009446114
"Chr08","580097","C","T",52,43,95,160,57,78,135,160,0.577777777777778,0.452631578947368,0.473913043478261,0.125146198830409
"Chr08","580262","A","G",66,51,117,136,70,78,148,136,0.527027027027027,0.435897435897436,0.513207547169811,0.0911295911295911
"Chr08","580280","C","T",58,48,106,146,69,80,149,146,0.536912751677852,0.452830188679245,0.498039215686275,0.0840825629986071
"Chr08","580526","G","A",31,27,58,155,44,51,95,155,0.536842105263158,0.46551724137931,0.490196078431373,0.0713248638838476
"Chr08","580745","G","T",20,16,36,160,28,41,69,160,0.594202898550725,0.444444444444444,0.457142857142857,0.14975845410628
"Chr08","582198","G","A",76,53,129,160,91,79,170,160,0.464705882352941,0.410852713178295,0.558528428093645,0.0538531691746466
"Chr08","582207","G","A",65,56,121,160,77,74,151,160,0.490066225165563,0.462809917355372,0.522058823529412,0.027256307810191
"Chr08","582265","G","T",57,45,102,160,62,66,128,160,0.515625,0.441176470588235,0.517391304347826,0.0744485294117647
"Chr08","582282","T","G",36,39,75,142,41,68,109,142,0.623853211009174,0.52,0.418478260869565,0.103853211009174
"Chr08","582292","A","G",39,39,78,140,40,70,110,140,0.636363636363636,0.5,0.420212765957447,0.136363636363636
"Chr08","582491","G","A",109,65,174,160,89,91,180,160,0.505555555555556,0.373563218390805,0.559322033898305,0.131992337164751
"Chr08","582525","G","A",101,57,158,141,85,84,169,141,0.497041420118343,0.360759493670886,0.568807339449541,0.136281926447457
"Chr08","582542","T","A",95,61,156,138,74,77,151,138,0.509933774834437,0.391025641025641,0.550488599348534,0.118908133808796
"Chr08","582575","G","C",74,62,136,138,66,80,146,138,0.547945205479452,0.455882352941176,0.49645390070922,0.0920628525382756
"Chr08","582602","C","T",78,48,126,160,59,62,121,160,0.512396694214876,0.380952380952381,0.554655870445344,0.131444313262495
"Chr08","582855","C","A",79,63,142,147,76,96,172,147,0.558139534883721,0.443661971830986,0.493630573248408,0.114477563052735
"Chr08","582951","C","T",74,52,126,139,84,91,175,139,0.52,0.412698412698413,0.524916943521595,0.107301587301587
"Chr08","582957","G","A",78,52,130,151,87,101,188,151,0.537234042553192,0.4,0.518867924528302,0.137234042553191
"Chr08","582983","A","C",71,42,113,160,85,91,176,160,0.517045454545455,0.371681415929204,0.539792387543253,0.145364038616251
"Chr08","582993","G","A",65,44,109,138,81,97,178,138,0.544943820224719,0.403669724770642,0.508710801393728,0.141274095454077
"Chr08","583012","A","G",79,46,125,138,83,99,182,138,0.543956043956044,0.368,0.527687296416938,0.175956043956044
"Chr08","583043","T","G",76,46,122,160,77,99,176,160,0.5625,0.377049180327869,0.513422818791946,0.185450819672131
"Chr08","583173","G","A",65,37,102,143,66,67,133,143,0.503759398496241,0.362745098039216,0.557446808510638,0.141014300457025
"Chr08","583186","T","C",68,36,104,160,76,67,143,160,0.468531468531469,0.346153846153846,0.582995951417004,0.122377622377622
"Chr08","583282","T","A",98,49,147,160,89,86,175,160,0.491428571428571,0.333333333333333,0.580745341614907,0.158095238095238
"Chr08","583290","T","C",100,46,146,160,92,78,170,160,0.458823529411765,0.315068493150685,0.607594936708861,0.14375503626108
"Chr08","583545","A","G",88,42,130,160,68,86,154,160,0.558441558441558,0.323076923076923,0.549295774647887,0.235364635364635
"Chr08","583572","C","T",94,39,133,160,61,93,154,160,0.603896103896104,0.293233082706767,0.54006968641115,0.310663021189337
"Chr08","583660","C","T",90,59,149,138,67,109,176,138,0.619318181818182,0.395973154362416,0.483076923076923,0.223345027455766
"Chr08","583667","A","G",91,51,142,160,68,95,163,160,0.582822085889571,0.359154929577465,0.521311475409836,0.223667156312106
"Chr08","583723","T","G",83,41,124,139,62,67,129,139,0.51937984496124,0.330645161290323,0.573122529644269,0.188734683670918
"Chr08","583736","A","T",78,43,121,143,63,69,132,143,0.522727272727273,0.355371900826446,0.557312252964427,0.167355371900826
"Chr08","583743","T","C",77,42,119,160,66,69,135,160,0.511111111111111,0.352941176470588,0.562992125984252,0.158169934640523
"Chr08","583769","T","G",84,45,129,147,60,62,122,147,0.508196721311475,0.348837209302326,0.573705179282869,0.15935951200915
"Chr08","583883","A","G",85,45,130,160,82,79,161,160,0.490683229813665,0.346153846153846,0.573883161512027,0.144529383659818
"Chr08","584034","G","A",96,100,196,142,69,157,226,142,0.694690265486726,0.510204081632653,0.390995260663507,0.184486183854073
"Chr08","584179","T","C",68,60,128,139,79,93,172,139,0.540697674418605,0.46875,0.49,0.0719476744186046
"Chr08","584186","T","C",70,60,130,160,81,95,176,160,0.539772727272727,0.461538461538462,0.493464052287582,0.0782342657342657
"Chr08","584233","G","A",71,60,131,141,68,90,158,141,0.569620253164557,0.458015267175573,0.480968858131488,0.111604985988984
"Chr08","584295","T","C",85,45,130,160,71,70,141,160,0.49645390070922,0.346153846153846,0.575645756457565,0.150300054555374
"Chr08","584304","C","T",91,41,132,141,70,65,135,141,0.481481481481481,0.310606060606061,0.602996254681648,0.170875420875421
"Chr08","584386","C","G",102,41,143,160,72,74,146,160,0.506849315068493,0.286713286713287,0.602076124567474,0.220136028355206
"Chr08","584494","T","C",88,47,135,160,81,58,139,160,0.41726618705036,0.348148148148148,0.616788321167883,0.0691180389022116
"Chr08","584586","A","G",60,44,104,160,73,31,104,160,0.298076923076923,0.423076923076923,0.639423076923077,-0.125
"Chr08","584677","G","A",69,39,108,142,56,43,99,142,0.434343434343434,0.361111111111111,0.603864734299517,0.0732323232323233
"Chr08","584686","A","G",70,46,116,142,60,47,107,142,0.439252336448598,0.396551724137931,0.582959641255605,0.0427006123106671
"Chr08","584722","G","A",73,38,111,141,45,60,105,141,0.571428571428571,0.342342342342342,0.546296296296296,0.229086229086229
"Chr08","584748","A","T",72,43,115,147,43,68,111,147,0.612612612612613,0.373913043478261,0.508849557522124,0.238699569134352
"Chr08","584760","T","C",69,47,116,160,54,60,114,160,0.526315789473684,0.405172413793103,0.534782608695652,0.121143375680581
"Chr08","584966","C","T",65,40,105,150,67,40,107,150,0.373831775700935,0.380952380952381,0.622641509433962,-0.00712060525144637
"Chr08","585007","C","T",72,35,107,160,67,37,104,160,0.355769230769231,0.327102803738318,0.658767772511848,0.028666427030913
"Chr08","585349","G","A",73,40,113,146,56,71,127,146,0.559055118110236,0.353982300884956,0.5375,0.20507281722528
"Chr08","589079","A","G",72,62,134,160,111,95,206,160,0.461165048543689,0.462686567164179,0.538235294117647,-0.00152151862048977
"Chr08","589109","G","A",48,66,114,160,93,108,201,160,0.537313432835821,0.578947368421053,0.447619047619048,-0.0416339355852318
"Chr08","589121","C","A",50,70,120,143,97,100,197,143,0.50761421319797,0.583333333333333,0.463722397476341,-0.0757191201353639
"Chr08","589136","G","A",40,60,100,160,79,90,169,160,0.532544378698225,0.6,0.442379182156134,-0.0674556213017751
"Chr08","589149","C","T",40,56,96,144,83,89,172,144,0.517441860465116,0.583333333333333,0.458955223880597,-0.0658914728682171
"Chr08","589177","G","A",31,53,84,160,83,84,167,160,0.502994011976048,0.630952380952381,0.454183266932271,-0.127958368976333
"Chr08","589209","A","C",32,67,99,144,90,74,164,144,0.451219512195122,0.676767676767677,0.463878326996198,-0.225548164572555
"Chr08","589225","A","C",35,73,108,146,85,56,141,146,0.397163120567376,0.675925925925926,0.481927710843373,-0.27876280535855
"Chr08","589262","T","C",35,58,93,150,68,49,117,150,0.418803418803419,0.623655913978495,0.49047619047619,-0.204852495175076
"Chr08","589439","G","T",27,45,72,160,39,43,82,160,0.524390243902439,0.625,0.428571428571429,-0.100609756097561
"Chr08","607423","G","A",21,16,37,160,29,24,53,160,0.452830188679245,0.432432432432432,0.555555555555556,0.0203977562468128
"Chr08","607453","G","A",17,14,31,148,23,25,48,148,0.520833333333333,0.451612903225806,0.506329113924051,0.0692204301075269
"Chr08","608809","C","G",39,43,82,137,86,43,129,137,0.333333333333333,0.524390243902439,0.592417061611374,-0.191056910569106
"Chr08","608917","G","A",39,48,87,160,68,50,118,160,0.423728813559322,0.551724137931034,0.521951219512195,-0.127995324371712
"Chr08","609998","T","G",56,60,116,160,77,42,119,160,0.352941176470588,0.517241379310345,0.565957446808511,-0.164300202839757
"Chr08","610110","A","C",92,106,198,160,166,96,262,160,0.366412213740458,0.535353535353535,0.560869565217391,-0.168941321613077
"Chr08","610193","C","G",89,123,212,160,157,130,287,160,0.452961672473868,0.580188679245283,0.492985971943888,-0.127227006771415
"Chr08","610234","A","G",81,90,171,136,105,73,178,136,0.410112359550562,0.526315789473684,0.532951289398281,-0.116203429923122
"Chr08","610285","T","A",81,81,162,139,91,68,159,139,0.427672955974843,0.5,0.53582554517134,-0.0723270440251572
"Chr08","610379","C","A",53,66,119,160,82,59,141,160,0.418439716312057,0.554621848739496,0.519230769230769,-0.136182132427439
"Chr08","610441","A","C",45,73,118,160,79,62,141,160,0.439716312056738,0.61864406779661,0.478764478764479,-0.178927755739873
"Chr08","610453","C","A",70,85,155,160,104,80,184,160,0.434782608695652,0.548387096774194,0.513274336283186,-0.113604488078541
"Chr08","610783","G","A",74,32,106,160,57,61,118,160,0.516949152542373,0.30188679245283,0.584821428571429,0.215062360089543
"Chr08","611466","G","T",25,46,71,160,40,46,86,160,0.534883720930233,0.647887323943662,0.414012738853503,-0.113003603013429
"Chr08","612003","T","C",41,27,68,139,47,37,84,139,0.44047619047619,0.397058823529412,0.578947368421053,0.0434173669467787
"Chr08","614315","C","T",84,49,133,160,113,72,185,160,0.389189189189189,0.368421052631579,0.619496855345912,0.0207681365576103
"Chr08","614727","C","T",59,72,131,160,74,88,162,160,0.54320987654321,0.549618320610687,0.453924914675768,-0.0064084440674772
"Chr08","616875","T","C",113,64,177,160,118,107,225,160,0.475555555555556,0.361581920903955,0.574626865671642,0.113973634651601
"Chr08","616899","T","C",132,65,197,138,139,115,254,138,0.452755905511811,0.32994923857868,0.600886917960089,0.122806666933131
"Chr08","617738","G","T",81,94,175,138,136,112,248,138,0.451612903225806,0.537142857142857,0.513002364066194,-0.0855299539170507
"Chr08","619116","G","C",56,36,92,160,56,58,114,160,0.508771929824561,0.391304347826087,0.543689320388349,0.117467581998474
"Chr08","619990","A","G",76,41,117,158,70,69,139,158,0.496402877697842,0.35042735042735,0.5703125,0.145975527270491
"Chr08","620484","C","T",56,37,93,145,50,56,106,145,0.528301886792453,0.397849462365591,0.532663316582915,0.130452424426861
"Chr08","621410","G","A",117,79,196,160,120,86,206,160,0.41747572815534,0.403061224489796,0.58955223880597,0.0144145036655439
"Chr08","623265","G","A",93,44,137,136,76,84,160,136,0.525,0.321167883211679,0.569023569023569,0.203832116788321
"Chr08","625841","A","T",67,41,108,160,63,65,128,160,0.5078125,0.37962962962963,0.550847457627119,0.12818287037037
"Chr08","625879","C","T",67,46,113,140,69,62,131,140,0.473282442748092,0.407079646017699,0.557377049180328,0.0662027967303925
"Chr08","626686","C","G",102,78,180,141,114,76,190,141,0.4,0.433333333333333,0.583783783783784,-0.0333333333333333
"Chr08","629371","G","A",40,36,76,155,45,38,83,155,0.457831325301205,0.473684210526316,0.534591194968553,-0.015852885225111
"Chr08","629750","C","T",89,44,133,160,99,70,169,160,0.414201183431953,0.330827067669173,0.622516556291391,0.0833741157627798
"Chr08","629789","G","A",79,40,119,160,80,60,140,160,0.428571428571429,0.336134453781513,0.613899613899614,0.0924369747899159
"Chr08","629983","C","A",40,68,108,144,64,65,129,144,0.503875968992248,0.62962962962963,0.438818565400844,-0.125753660637382
"Chr08","630103","C","T",77,53,130,137,96,62,158,137,0.392405063291139,0.407692307692308,0.600694444444444,-0.0152872444011685
"Chr08","630118","T","C",76,48,124,160,93,56,149,160,0.375838926174497,0.387096774193548,0.619047619047619,-0.0112578480190517
"Chr08","630229","G","A",69,33,102,160,77,65,142,160,0.457746478873239,0.323529411764706,0.598360655737705,0.134217067108534
"Chr08","630478","T","C",36,58,94,160,67,63,130,160,0.484615384615385,0.617021276595745,0.459821428571429,-0.13240589198036
"Chr08","630494","T","G",31,50,81,141,62,58,120,141,0.483333333333333,0.617283950617284,0.462686567164179,-0.133950617283951
"Chr08","630571","A","T",50,45,95,160,52,53,105,160,0.504761904761905,0.473684210526316,0.51,0.031077694235589
"Chr08","630626","T","G",64,47,111,142,74,70,144,142,0.486111111111111,0.423423423423423,0.541176470588235,0.0626876876876877
"Chr08","630667","A","T",53,74,127,160,89,82,171,160,0.47953216374269,0.582677165354331,0.476510067114094,-0.103145001611641
"Chr08","630707","G","A",60,79,139,136,100,97,197,136,0.49238578680203,0.568345323741007,0.476190476190476,-0.0759595369389768
"Chr08","630777","A","T",65,66,131,160,82,83,165,160,0.503030303030303,0.50381679389313,0.496621621621622,-0.000786490862826672
"Chr08","630871","A","G",53,61,114,138,60,53,113,138,0.469026548672566,0.535087719298246,0.497797356828194,-0.0660611706256792
"Chr08","630987","T","C",49,64,113,143,81,38,119,143,0.319327731092437,0.566371681415929,0.560344827586207,-0.247043950323492
"Chr08","631011","T","C",52,72,124,160,84,46,130,160,0.353846153846154,0.580645161290323,0.535433070866142,-0.226799007444169
"Chr08","631032","A","G",49,68,117,142,84,46,130,142,0.353846153846154,0.581196581196581,0.538461538461538,-0.227350427350427
"Chr08","631043","C","T",59,74,133,160,101,55,156,160,0.352564102564103,0.556390977443609,0.55363321799308,-0.203826874879506
"Chr08","631079","G","C",85,130,215,160,120,107,227,160,0.47136563876652,0.604651162790698,0.463800904977376,-0.133285524024178
"Chr08","631099","C","T",80,132,212,141,122,108,230,141,0.469565217391304,0.622641509433962,0.457013574660633,-0.153076292042658
"Chr08","631146","C","T",75,137,212,137,119,118,237,137,0.49789029535865,0.64622641509434,0.432071269487751,-0.14833611973569
"Chr08","631255","A","G",72,143,215,160,116,111,227,160,0.488986784140969,0.665116279069767,0.425339366515837,-0.176129494928798
"Chr08","631294","G","T",76,134,210,160,111,113,224,160,0.504464285714286,0.638095238095238,0.430875576036866,-0.133630952380952
"Chr08","631323","C","T",78,136,214,160,107,107,214,160,0.5,0.635514018691589,0.432242990654206,-0.135514018691589
"Chr08","631373","T","C",56,84,140,160,74,73,147,160,0.496598639455782,0.6,0.452961672473868,-0.103401360544218
"Chr08","631381","T","C",55,89,144,137,75,79,154,137,0.512987012987013,0.618055555555556,0.436241610738255,-0.105068542568543
"Chr08","631459","A","T",63,109,172,160,104,99,203,160,0.487684729064039,0.633720930232558,0.445333333333333,-0.146036201168519
"Chr08","631486","T","G",69,102,171,160,88,89,177,160,0.502824858757062,0.596491228070175,0.451149425287356,-0.0936663693131132
"Chr08","631500","T","A",71,107,178,160,87,100,187,160,0.53475935828877,0.601123595505618,0.432876712328767,-0.0663642372168479
"Chr08","631551","A","G",73,147,220,139,101,128,229,139,0.558951965065502,0.668181818181818,0.387527839643653,-0.109229853116316
"Chr08","631565","C","T",71,142,213,140,101,126,227,140,0.555066079295154,0.666666666666667,0.390909090909091,-0.111600587371512
"Chr08","631647","A","C",67,152,219,160,110,126,236,160,0.533898305084746,0.694063926940639,0.389010989010989,-0.160165621855893
"Chr08","631655","G","A",61,155,216,136,113,119,232,136,0.512931034482759,0.717592592592593,0.388392857142857,-0.204661558109834
"Chr08","631663","G","C",71,146,217,160,115,114,229,160,0.497816593886463,0.672811059907834,0.417040358744395,-0.174994466021371
"Chr08","631923","G","T",112,69,181,160,118,109,227,160,0.480176211453745,0.38121546961326,0.563725490196078,0.0989607418404848
"Chr08","632084","A","C",43,88,131,160,64,107,171,160,0.625730994152047,0.67175572519084,0.354304635761589,-0.0460247310387929
"Chr08","632140","A","T",57,86,143,160,95,102,197,160,0.517766497461929,0.601398601398601,0.447058823529412,-0.0836321039366724
"Chr08","632268","C","G",84,30,114,158,89,59,148,158,0.398648648648649,0.263157894736842,0.66030534351145,0.135490753911807
"Chr08","633218","A","G",17,41,58,140,20,42,62,140,0.67741935483871,0.706896551724138,0.308333333333333,-0.0294771968854283
"Chr08","633258","G","A",23,48,71,160,29,42,71,160,0.591549295774648,0.676056338028169,0.366197183098592,-0.0845070422535211
"Chr08","633336","C","G",15,41,56,160,25,30,55,160,0.545454545454545,0.732142857142857,0.36036036036036,-0.186688311688312
"Chr08","633346","C","G",16,39,55,139,25,30,55,139,0.545454545454545,0.709090909090909,0.372727272727273,-0.163636363636364
"Chr08","633352","T","C",15,39,54,160,25,26,51,160,0.509803921568627,0.722222222222222,0.380952380952381,-0.212418300653595
"Chr08","633440","T","C",17,28,45,139,41,39,80,139,0.4875,0.622222222222222,0.464,-0.134722222222222
"Chr08","633458","G","A",16,34,50,149,42,47,89,149,0.528089887640449,0.68,0.41726618705036,-0.151910112359551
"Chr08","633668","G","A",34,64,98,160,79,60,139,160,0.431654676258993,0.653061224489796,0.476793248945148,-0.221406548230803
"Chr08","633714","C","T",42,69,111,160,94,76,170,160,0.447058823529412,0.621621621621622,0.483985765124555,-0.17456279809221
"Chr08","634478","A","G",29,46,75,139,67,43,110,139,0.390909090909091,0.613333333333333,0.518918918918919,-0.222424242424242
"Chr08","634489","G","A",29,51,80,160,70,42,112,160,0.375,0.6375,0.515625,-0.2625
"Chr08","634799","A","G",96,78,174,136,88,108,196,136,0.551020408163265,0.448275862068966,0.497297297297297,0.1027445460943
"Chr08","635497","C","T",46,33,79,142,58,51,109,142,0.467889908256881,0.417721518987342,0.553191489361702,0.050168389269539
"Chr08","635498","C","T",32,47,79,141,51,58,109,141,0.532110091743119,0.594936708860759,0.441489361702128,-0.0628266171176401
"Chr08","635971","C","T",79,43,122,149,54,57,111,149,0.513513513513513,0.352459016393443,0.570815450643777,0.161054497120071
"Chr08","636338","T","C",70,50,120,160,53,59,112,160,0.526785714285714,0.416666666666667,0.530172413793103,0.110119047619048
"Chr08","636584","C","T",26,33,59,140,38,34,72,140,0.472222222222222,0.559322033898305,0.488549618320611,-0.0870998116760828
"Chr08","637326","C","T",16,16,32,160,7,21,28,117,0.75,0.5,0.383333333333333,0.25
"Chr08","637854","C","T",53,42,95,140,68,53,121,140,0.43801652892562,0.442105263157895,0.560185185185185,-0.0040887342322749
"Chr08","637888","C","T",58,43,101,147,65,60,125,147,0.48,0.425742574257426,0.544247787610619,0.0542574257425743
"Chr08","637982","G","A",59,48,107,160,59,77,136,160,0.566176470588235,0.448598130841121,0.48559670781893,0.117578339747114
"Chr08","638022","G","A",55,42,97,145,43,72,115,145,0.626086956521739,0.43298969072165,0.462264150943396,0.19309726580009
"Chr08","638947","A","C",49,40,89,160,43,59,102,160,0.57843137254902,0.449438202247191,0.481675392670157,0.128993170301829
"Chr08","639413","T","G",71,41,112,160,56,77,133,160,0.578947368421053,0.366071428571429,0.518367346938776,0.212875939849624
"Chr08","639456","T","C",71,49,120,160,66,78,144,160,0.541666666666667,0.408333333333333,0.518939393939394,0.133333333333333
"Chr08","639664","A","G",52,74,126,139,73,74,147,139,0.503401360544218,0.587301587301587,0.457875457875458,-0.0839002267573696
"Chr08","640023","G","T",41,62,103,136,69,61,130,136,0.469230769230769,0.601941747572815,0.472103004291845,-0.132710978342046
"Chr08","640352","G","T",25,48,73,153,65,42,107,153,0.392523364485981,0.657534246575342,0.5,-0.265010882089361
"Chr08","640456","G","A",14,29,43,139,22,22,44,139,0.5,0.674418604651163,0.413793103448276,-0.174418604651163
"Chr08","640563","T","C",27,31,58,160,31,26,57,160,0.456140350877193,0.53448275862069,0.504347826086956,-0.0783424077434967
"Chr08","640859","C","T",25,56,81,144,49,50,99,144,0.505050505050505,0.691358024691358,0.411111111111111,-0.186307519640853
"Chr08","641565","A","G",19,33,52,138,40,34,74,138,0.459459459459459,0.634615384615385,0.468253968253968,-0.175155925155925
"Chr08","641907","G","A",41,84,125,160,66,83,149,160,0.557046979865772,0.672,0.39051094890511,-0.114953020134228
"Chr08","642182","C","G",31,56,87,145,59,58,117,145,0.495726495726496,0.64367816091954,0.441176470588235,-0.147951665193044
"Chr08","642217","G","A",27,62,89,139,59,58,117,139,0.495726495726496,0.696629213483146,0.41747572815534,-0.20090271775665
"Chr08","642357","T","C",35,58,93,160,58,60,118,160,0.508474576271186,0.623655913978495,0.440758293838863,-0.115181337707308
"Chr08","642461","G","C",31,58,89,140,63,60,123,140,0.48780487804878,0.651685393258427,0.443396226415094,-0.163880515209647
"Chr08","642874","G","A",32,46,78,160,53,41,94,160,0.436170212765957,0.58974358974359,0.494186046511628,-0.153573376977632
"Chr08","643629","A","G",45,71,116,145,86,75,161,145,0.46583850931677,0.612068965517241,0.472924187725632,-0.146230456200471
"Chr08","644951","C","G",15,22,37,160,17,29,46,160,0.630434782608696,0.594594594594595,0.385542168674699,0.035840188014101
"Chr08","644973","A","G",16,13,29,143,16,26,42,143,0.619047619047619,0.448275862068966,0.450704225352113,0.170771756978654
"Chr08","645088","A","G",23,17,40,146,29,44,73,146,0.602739726027397,0.425,0.460176991150442,0.177739726027397
"Chr08","645966","T","G",35,37,72,141,38,35,73,141,0.479452054794521,0.513888888888889,0.503448275862069,-0.0344368340943683
"Chr08","646001","C","G",36,35,71,160,34,36,70,160,0.514285714285714,0.492957746478873,0.49645390070922,0.021327967806841
"Chr08","646045","C","T",33,35,68,143,29,30,59,143,0.508474576271186,0.514705882352941,0.488188976377953,-0.00623130608175471
"Chr08","646177","T","G",31,52,83,160,27,30,57,160,0.526315789473684,0.626506024096386,0.414285714285714,-0.100190234622701
"Chr08","646607","T","C",12,15,27,160,16,12,28,160,0.428571428571429,0.555555555555556,0.509090909090909,-0.126984126984127
"Chr08","647328","T","C",31,48,79,160,48,39,87,160,0.448275862068966,0.607594936708861,0.475903614457831,-0.159319074639895
"Chr08","647366","G","A",25,48,73,142,41,34,75,142,0.453333333333333,0.657534246575342,0.445945945945946,-0.204200913242009
"Chr08","647535","G","A",17,52,69,160,46,41,87,160,0.471264367816092,0.753623188405797,0.403846153846154,-0.282358820589705
"Chr08","648391","A","G",12,14,26,160,19,13,32,160,0.40625,0.538461538461538,0.53448275862069,-0.132211538461538
"Chr08","648566","G","T",20,22,42,143,32,25,57,143,0.43859649122807,0.523809523809524,0.525252525252525,-0.0852130325814537
"Chr08","648758","G","A",27,43,70,160,45,30,75,160,0.4,0.614285714285714,0.496551724137931,-0.214285714285714
"Chr08","648910","C","G",52,72,124,160,61,68,129,160,0.527131782945736,0.580645161290323,0.446640316205534,-0.0535133783445861
"Chr08","648937","G","T",57,75,132,160,69,66,135,160,0.488888888888889,0.568181818181818,0.471910112359551,-0.0792929292929294
"Chr08","649072","G","A",14,42,56,160,41,23,64,160,0.359375,0.75,0.458333333333333,-0.390625
"Chr08","649381","C","G",57,97,154,134,85,112,197,134,0.568527918781726,0.62987012987013,0.404558404558405,-0.061342211088404
"Chr08","650326","C","G",34,54,88,160,55,55,110,160,0.5,0.613636363636364,0.44949494949495,-0.113636363636364
"Chr08","650764","C","T",65,38,103,160,77,68,145,160,0.468965517241379,0.368932038834951,0.57258064516129,0.100033478406428
"Chr08","650808","A","G",72,45,117,139,70,72,142,139,0.507042253521127,0.384615384615385,0.548262548262548,0.122426868905742
"Chr08","650948","G","T",63,29,92,141,62,48,110,141,0.436363636363636,0.315217391304348,0.618811881188119,0.121146245059289
"Chr08","651591","G","A",14,8,22,142,13,9,22,160,0.409090909090909,0.363636363636364,0.613636363636364,0.0454545454545455
"Chr08","651718","G","A",14,19,33,146,11,8,19,146,0.421052631578947,0.575757575757576,0.480769230769231,-0.154704944178628
"Chr08","651723","G","A",14,16,30,143,12,9,21,143,0.428571428571429,0.533333333333333,0.509803921568627,-0.104761904761905
"Chr08","651764","G","A",18,12,30,160,9,10,19,160,0.526315789473684,0.4,0.551020408163265,0.126315789473684
"Chr08","653850","C","T",99,50,149,160,74,85,159,160,0.534591194968553,0.335570469798658,0.561688311688312,0.199020725169896
"Chr08","653957","C","T",91,58,149,137,103,113,216,137,0.523148148148148,0.389261744966443,0.531506849315069,0.133886403181705
"Chr08","655627","C","A",47,91,138,138,86,93,179,138,0.519553072625698,0.659420289855073,0.419558359621451,-0.139867217229374
"Chr08","656567","C","T",18,40,58,147,34,29,63,147,0.46031746031746,0.689655172413793,0.429752066115702,-0.229337712096333
"Chr08","656687","T","C",46,38,84,141,60,36,96,141,0.375,0.452380952380952,0.588888888888889,-0.0773809523809524
"Chr08","656748","C","G",26,39,65,160,38,43,81,160,0.530864197530864,0.6,0.438356164383562,-0.0691358024691358
"Chr08","656786","C","T",27,43,70,140,48,40,88,140,0.454545454545455,0.614285714285714,0.474683544303797,-0.15974025974026
"Chr08","657372","A","T",78,35,113,152,69,70,139,152,0.503597122302158,0.309734513274336,0.583333333333333,0.193862609027822
"Chr08","657389","A","G",79,32,111,148,66,76,142,148,0.535211267605634,0.288288288288288,0.573122529644269,0.246922979317345
"Chr08","658716","C","A",75,51,126,141,68,81,149,141,0.543624161073825,0.404761904761905,0.52,0.138862256311921
"Chr08","658781","A","C",46,73,119,151,78,53,131,151,0.404580152671756,0.613445378151261,0.496,-0.208865225479505
"Chr08","658924","C","T",56,34,90,160,38,49,87,160,0.563218390804598,0.377777777777778,0.531073446327684,0.18544061302682
"Chr08","659069","A","T",60,33,93,160,46,68,114,160,0.596491228070175,0.354838709677419,0.51207729468599,0.241652518392756
"Chr08","659098","T","C",72,34,106,160,52,77,129,160,0.596899224806202,0.320754716981132,0.527659574468085,0.276144507825069
"Chr08","659478","A","G",29,14,43,147,29,29,58,147,0.5,0.325581395348837,0.574257425742574,0.174418604651163
"Chr08","659548","C","G",34,17,51,160,27,31,58,160,0.53448275862069,0.333333333333333,0.559633027522936,0.201149425287356
"Chr08","659554","G","C",38,18,56,147,27,30,57,147,0.526315789473684,0.321428571428571,0.575221238938053,0.204887218045113
"Chr08","659563","A","G",37,18,55,142,27,28,55,142,0.509090909090909,0.327272727272727,0.581818181818182,0.181818181818182
"Chr08","659629","T","C",32,16,48,142,16,23,39,142,0.58974358974359,0.333333333333333,0.551724137931034,0.256410256410256
"Chr08","659665","A","G",37,18,55,160,17,20,37,160,0.540540540540541,0.327272727272727,0.58695652173913,0.213267813267813
"Chr08","660352","A","T",72,32,104,160,61,57,118,160,0.483050847457627,0.307692307692308,0.599099099099099,0.175358539765319
"Chr08","665420","G","C",23,71,94,101,46,62,108,160,0.574074074074074,0.75531914893617,0.341584158415842,-0.181245074862096
"Chr08","665501","A","G",67,38,105,160,68,70,138,160,0.507246376811594,0.361904761904762,0.555555555555556,0.145341614906832
"Chr08","665515","A","G",68,38,106,143,67,66,133,143,0.496240601503759,0.358490566037736,0.564853556485356,0.137750035466024
"Chr08","665522","C","T",70,39,109,148,68,68,136,148,0.5,0.357798165137615,0.563265306122449,0.142201834862385
"Chr08","665529","C","T",64,38,102,160,65,64,129,160,0.496124031007752,0.372549019607843,0.558441558441558,0.123575011399909
"Chr08","665530","C","T",38,62,100,160,63,67,130,160,0.515384615384615,0.62,0.439130434782609,-0.104615384615385
"Chr08","665536","A","G",61,37,98,142,70,59,129,142,0.457364341085271,0.377551020408163,0.577092511013216,0.0798133206771081
"Chr08","665579","G","C",52,26,78,141,58,31,89,141,0.348314606741573,0.333333333333333,0.658682634730539,0.0149812734082397
"Chr08","665839","A","G",60,19,79,160,52,31,83,160,0.373493975903614,0.240506329113924,0.691358024691358,0.13298764678969
"Chr08","666210","C","T",64,36,100,160,91,63,154,160,0.409090909090909,0.36,0.610236220472441,0.0490909090909091
"Chr08","666298","A","G",66,31,97,146,91,57,148,146,0.385135135135135,0.319587628865979,0.640816326530612,0.0655475062691558
"Chr08","667403","A","G",41,40,81,141,51,60,111,141,0.540540540540541,0.493827160493827,0.479166666666667,0.0467133800467134
"Chr08","667424","C","T",47,36,83,160,53,57,110,160,0.518181818181818,0.433734939759036,0.518134715025907,0.084446878422782
"Chr08","667986","C","A",95,49,144,143,50,68,118,143,0.576271186440678,0.340277777777778,0.553435114503817,0.2359934086629
"Chr08","668018","T","A",102,53,155,138,62,70,132,138,0.53030303030303,0.341935483870968,0.571428571428571,0.188367546432063
"Chr08","668060","C","G",112,62,174,136,78,73,151,136,0.483443708609272,0.35632183908046,0.584615384615385,0.127121869528812
"Chr08","668083","A","C",95,60,155,139,76,76,152,139,0.5,0.387096774193548,0.55700325732899,0.112903225806452
"Chr08","668093","A","C",98,57,155,143,74,77,151,143,0.509933774834437,0.367741935483871,0.562091503267974,0.142191839350566
"Chr08","668523","G","C",102,47,149,160,78,73,151,160,0.483443708609272,0.315436241610738,0.6,0.168007466998533
"Chr08","668594","T","C",89,43,132,160,79,61,140,160,0.435714285714286,0.325757575757576,0.617647058823529,0.10995670995671
"Chr08","668833","C","T",115,54,169,160,130,126,256,160,0.4921875,0.319526627218935,0.576470588235294,0.172660872781065
"Chr08","668905","G","A",86,54,140,160,101,99,200,160,0.495,0.385714285714286,0.55,0.109285714285714
"Chr08","668913","T","G",87,53,140,160,103,90,193,160,0.466321243523316,0.378571428571429,0.570570570570571,0.0877498149518875
"Chr08","669258","A","C",86,32,118,160,62,85,147,160,0.578231292517007,0.271186440677966,0.558490566037736,0.307044851839041
"Chr08","669773","G","A",72,57,129,160,79,106,185,160,0.572972972972973,0.441860465116279,0.480891719745223,0.131112507856694
"Chr08","670087","T","C",137,74,211,136,134,92,226,136,0.407079646017699,0.350710900473934,0.620137299771167,0.0563687455437655
"Chr08","670409","A","G",95,51,146,160,84,91,175,160,0.52,0.349315068493151,0.557632398753894,0.170684931506849
"Chr08","670540","T","C",75,57,132,160,59,78,137,160,0.569343065693431,0.431818181818182,0.49814126394052,0.137524883875249
"Chr08","670679","C","T",103,56,159,160,97,80,177,160,0.451977401129944,0.352201257861635,0.595238095238095,0.0997761432683083
"Chr08","671447","T","C",43,68,111,160,73,73,146,160,0.5,0.612612612612613,0.45136186770428,-0.112612612612613
"Chr08","671466","A","G",72,43,115,160,63,68,131,160,0.519083969465649,0.373913043478261,0.548780487804878,0.145170925987388
"Chr08","672478","G","T",62,68,130,160,80,63,143,160,0.440559440559441,0.523076923076923,0.52014652014652,-0.0825174825174825
"Chr08","672609","C","T",67,78,145,160,122,65,187,160,0.347593582887701,0.537931034482759,0.569277108433735,-0.190337451595058
"Chr08","672745","C","A",43,73,116,142,70,69,139,142,0.496402877697842,0.629310344827586,0.443137254901961,-0.132907467129744
"Chr08","673034","G","A",68,73,141,153,137,47,184,153,0.255434782608696,0.517730496453901,0.630769230769231,-0.262295713845205
"Chr08","674950","T","C",63,31,94,148,79,65,144,148,0.451388888888889,0.329787234042553,0.596638655462185,0.121601654846336
"Chr08","675020","C","G",75,39,114,160,78,65,143,160,0.454545454545455,0.342105263157895,0.595330739299611,0.11244019138756
"Chr08","675524","A","G",48,27,75,142,45,51,96,142,0.53125,0.36,0.543859649122807,0.17125
"Chr08","675545","A","G",30,46,76,160,63,48,111,160,0.432432432432432,0.605263157894737,0.497326203208556,-0.172830725462304
"Chr08","675827","T","A",44,72,116,143,74,57,131,143,0.435114503816794,0.620689655172414,0.477732793522267,-0.18557515135562
"Chr08","676140","G","T",51,63,114,160,70,59,129,160,0.457364341085271,0.552631578947368,0.497942386831276,-0.0952672378620972
"Chr08","676183","C","T",63,77,140,160,76,71,147,160,0.482993197278912,0.55,0.484320557491289,-0.0670068027210885
"Chr08","676441","C","G",71,63,134,137,75,40,115,137,0.347826086956522,0.470149253731343,0.586345381526104,-0.122323166774822
"Chr08","676525","A","T",70,69,139,160,77,62,139,160,0.446043165467626,0.496402877697842,0.528776978417266,-0.0503597122302158
"Chr08","676587","G","C",98,63,161,160,78,82,160,160,0.5125,0.391304347826087,0.548286604361371,0.121195652173913
"Chr08","676818","T","A",78,48,126,138,86,93,179,138,0.519553072625698,0.380952380952381,0.537704918032787,0.138600691673317
"Chr08","677069","T","C",64,61,125,160,70,103,173,160,0.595375722543353,0.488,0.449664429530201,0.107375722543353
"Chr08","677149","G","C",76,61,137,160,84,84,168,160,0.5,0.445255474452555,0.524590163934426,0.0547445255474452
"Chr08","677246","T","C",102,52,154,137,98,92,190,137,0.484210526315789,0.337662337662338,0.581395348837209,0.146548188653452
"Chr08","677377","G","A",67,56,123,151,70,77,147,151,0.523809523809524,0.455284552845528,0.507407407407407,0.0685249709639954
"Chr08","677406","C","T",66,71,137,160,76,82,158,160,0.518987341772152,0.518248175182482,0.48135593220339,0.000739166589670104
"Chr08","677413","A","G",75,77,152,136,82,79,161,136,0.490683229813665,0.506578947368421,0.501597444089457,-0.0158957175547564
"Chr08","677480","T","G",86,76,162,160,83,98,181,160,0.541436464088398,0.469135802469136,0.492711370262391,0.072300661619262
"Chr08","677569","A","C",76,47,123,140,83,63,146,140,0.431506849315068,0.382113821138211,0.591078066914498,0.0493930281768571
"Chr08","677683","T","G",79,62,141,136,84,71,155,136,0.458064516129032,0.439716312056738,0.550675675675676,0.0183482040722946
"Chr08","677801","G","T",93,59,152,142,81,73,154,142,0.474025974025974,0.388157894736842,0.568627450980392,0.0858680792891319
"Chr08","677854","T","A",82,62,144,160,68,82,150,160,0.546666666666667,0.430555555555556,0.510204081632653,0.116111111111111
"Chr08","678005","T","G",85,66,151,140,86,89,175,140,0.508571428571429,0.437086092715232,0.524539877300613,0.0714853358561968
"Chr08","679809","A","G",137,59,196,160,75,92,167,160,0.550898203592814,0.301020408163265,0.584022038567493,0.249877795429549
"Chr08","679886","G","T",112,65,177,160,69,98,167,160,0.586826347305389,0.367231638418079,0.526162790697674,0.21959470888731
"Chr08","679921","G","A",96,64,160,160,75,104,179,160,0.581005586592179,0.4,0.504424778761062,0.181005586592179
"Chr08","679992","T","C",75,47,122,139,68,79,147,139,0.537414965986395,0.385245901639344,0.531598513011152,0.15216906434705
"Chr08","680209","T","C",108,47,155,160,94,113,207,160,0.545893719806763,0.303225806451613,0.558011049723757,0.24266791335515
"Chr08","680245","C","T",102,69,171,140,99,103,202,140,0.50990099009901,0.403508771929825,0.53887399463807,0.106392218169185
"Chr08","680584","A","G",86,53,139,140,93,71,164,140,0.432926829268293,0.381294964028777,0.590759075907591,0.0516318652395157
"Chr08","680656","A","G",87,59,146,139,75,75,150,139,0.5,0.404109589041096,0.547297297297297,0.0958904109589041
"Chr08","680718","A","G",100,59,159,160,72,88,160,160,0.55,0.371069182389937,0.539184952978056,0.178930817610063
"Chr08","680725","T","A",101,57,158,160,70,90,160,160,0.5625,0.360759493670886,0.537735849056604,0.201740506329114
"Chr08","680869","T","C",88,56,144,160,86,72,158,160,0.455696202531646,0.388888888888889,0.576158940397351,0.0668073136427567
"Chr08","680880","T","C",52,89,141,136,72,92,164,136,0.560975609756098,0.631205673758865,0.40655737704918,-0.0702300640027677
"Chr08","680914","G","A",89,49,138,160,80,63,143,160,0.440559440559441,0.355072463768116,0.601423487544484,0.0854869767913246
"Chr08","681016","C","T",82,57,139,139,73,73,146,139,0.5,0.410071942446043,0.543859649122807,0.0899280575539568
"Chr08","681137","C","A",71,41,112,144,81,74,155,144,0.47741935483871,0.366071428571429,0.569288389513109,0.111347926267281
"Chr08","681174","T","C",62,24,86,160,65,64,129,160,0.496124031007752,0.27906976744186,0.590697674418605,0.217054263565891
"Chr08","681220","C","G",66,28,94,139,62,64,126,139,0.507936507936508,0.297872340425532,0.581818181818182,0.210064167510976
"Chr08","681226","A","G",66,29,95,160,62,65,127,160,0.511811023622047,0.305263157894737,0.576576576576577,0.20654786572731
"Chr08","681238","A","G",66,27,93,160,62,66,128,160,0.515625,0.290322580645161,0.579185520361991,0.225302419354839
"Chr08","681268","G","A",55,35,90,144,61,53,114,144,0.464912280701754,0.388888888888889,0.568627450980392,0.0760233918128655
"Chr08","681322","A","G",60,35,95,160,61,53,114,160,0.464912280701754,0.368421052631579,0.578947368421053,0.0964912280701755
"Chr08","681335","G","A",54,38,92,160,57,50,107,160,0.467289719626168,0.41304347826087,0.557788944723618,0.0542462413652987
"Chr08","681456","A","C",48,30,78,145,50,46,96,145,0.479166666666667,0.384615384615385,0.563218390804598,0.094551282051282
"Chr08","681625","G","A",30,16,46,160,37,34,71,160,0.47887323943662,0.347826086956522,0.572649572649573,0.131047152480098
"Chr08","681706","T","A",30,12,42,160,29,24,53,160,0.452830188679245,0.285714285714286,0.621052631578947,0.16711590296496
"Chr08","681729","C","T",32,8,40,127,35,22,57,142,0.385964912280702,0.2,0.690721649484536,0.185964912280702
"Chr08","681760","A","G",23,9,32,138,24,21,45,152,0.466666666666667,0.28125,0.61038961038961,0.185416666666667
"Chr08","681768","C","A",25,8,33,124,27,20,47,145,0.425531914893617,0.242424242424242,0.65,0.183107672469375
"Chr08","681832","C","G",15,11,26,160,32,17,49,160,0.346938775510204,0.423076923076923,0.626666666666667,-0.076138147566719
"Chr08","683791","C","T",20,46,66,160,37,43,80,160,0.5375,0.696969696969697,0.39041095890411,-0.159469696969697
"Chr08","683890","C","G",23,32,55,160,33,34,67,160,0.507462686567164,0.581818181818182,0.459016393442623,-0.0743554952510176
"Chr08","685468","G","A",25,56,81,139,45,49,94,139,0.521276595744681,0.691358024691358,0.4,-0.170081428946677
"Chr08","685529","G","A",71,37,108,160,74,57,131,160,0.435114503816794,0.342592592592593,0.606694560669456,0.0925219112242013
"Chr08","685582","C","A",49,72,121,138,57,79,136,138,0.580882352941177,0.59504132231405,0.412451361867704,-0.0141589693728731
"Chr08","685593","T","A",52,77,129,160,55,78,133,160,0.586466165413534,0.596899224806202,0.408396946564886,-0.0104330593926677
"Chr08","685692","A","C",58,51,109,139,72,46,118,139,0.389830508474576,0.467889908256881,0.572687224669604,-0.0780593997823045
"Chr08","685772","C","G",45,54,99,143,75,64,139,143,0.460431654676259,0.545454545454545,0.504201680672269,-0.0850228907782864
"Chr08","686041","T","C",56,78,134,160,87,87,174,160,0.5,0.582089552238806,0.464285714285714,-0.082089552238806
"Chr08","686091","A","C",73,117,190,139,89,106,195,139,0.543589743589744,0.615789473684211,0.420779220779221,-0.072199730094467
"Chr08","687223","G","A",14,19,33,143,17,16,33,143,0.484848484848485,0.575757575757576,0.46969696969697,-0.0909090909090909
"Chr08","687862","A","C",13,8,21,147,14,12,26,147,0.461538461538462,0.380952380952381,0.574468085106383,0.0805860805860806
"Chr08","687883","C","A",13,7,20,143,16,11,27,160,0.407407407407407,0.35,0.617021276595745,0.0574074074074074
"Chr08","688265","C","A",9,6,15,138,10,8,18,145,0.444444444444444,0.4,0.575757575757576,0.0444444444444444
"Chr08","688288","G","A",9,7,16,144,7,7,14,144,0.5,0.4375,0.533333333333333,0.0625
"Chr08","689128","C","T",55,31,86,160,47,29,76,160,0.381578947368421,0.36046511627907,0.62962962962963,0.0211138310893513
"Chr08","689147","AT","AC",54,31,85,160,42,33,75,160,0.44,0.364705882352941,0.6,0.0752941176470588
"Chr08","689420","G","T",26,14,40,160,23,15,38,160,0.394736842105263,0.35,0.628205128205128,0.0447368421052632
"Chr08","689452","A","G",16,11,27,147,16,13,29,147,0.448275862068966,0.407407407407407,0.571428571428571,0.0408684546615581
"Chr08","699548","G","A",24,18,42,137,36,32,68,160,0.470588235294118,0.428571428571429,0.545454545454545,0.0420168067226891
"Chr08","749240","A","G",22,31,53,160,42,33,75,160,0.44,0.584905660377358,0.5,-0.144905660377358
"Chr08","750302","G","C",40,75,115,160,69,67,136,160,0.492647058823529,0.652173913043478,0.434262948207171,-0.159526854219949
"Chr08","752022","A","G",0,10,10,33,2,10,12,19,0.833333333333333,1,0.0909090909090909,-0.166666666666667
"Chr08","774199","C","T",118,69,187,142,107,103,210,142,0.49047619047619,0.368983957219251,0.566750629722922,0.121492233256939
"Chr08","774402","T","C",79,39,118,160,69,69,138,160,0.5,0.330508474576271,0.578125,0.169491525423729
"Chr08","774471","A","C",57,30,87,141,60,39,99,141,0.393939393939394,0.344827586206897,0.629032258064516,0.0491118077324973
"Chr08","775918","C","A",47,49,96,160,62,78,140,160,0.557142857142857,0.510416666666667,0.461864406779661,0.0467261904761905
"Chr08","776022","G","A",63,48,111,160,63,68,131,160,0.519083969465649,0.432432432432432,0.520661157024793,0.0866515370332164
"Chr08","776517","A","G",46,58,104,144,46,56,102,144,0.549019607843137,0.557692307692308,0.446601941747573,-0.00867269984917041
"Chr08","776972","A","G",57,61,118,160,62,58,120,160,0.483333333333333,0.516949152542373,0.5,-0.0336158192090395
"Chr08","777787","C","T",92,61,153,160,81,92,173,160,0.531791907514451,0.398692810457516,0.530674846625767,0.133099097056934
"Chr08","778070","A","C",100,52,152,141,92,64,156,141,0.41025641025641,0.342105263157895,0.623376623376623,0.0681511470985155
"Chr08","778809","A","G",64,32,96,160,44,55,99,160,0.555555555555556,0.333333333333333,0.553846153846154,0.222222222222222
"Chr08","779196","T","C",61,118,179,144,108,95,203,144,0.467980295566502,0.659217877094972,0.442408376963351,-0.19123758152847
"Chr08","779359","A","T",108,56,164,160,104,113,217,160,0.52073732718894,0.341463414634146,0.556430446194226,0.179273912554794
"Chr08","780056","T","A",115,73,188,160,119,118,237,160,0.49789029535865,0.388297872340426,0.550588235294118,0.109592423018224
"Chr08","780650","C","A",96,57,153,137,84,85,169,137,0.502958579881657,0.372549019607843,0.559006211180124,0.130409560273814
"Chr08","782221","A","C",92,55,147,139,110,93,203,139,0.458128078817734,0.374149659863946,0.577142857142857,0.0839784189537884
"Chr08","782495","C","T",97,53,150,137,89,81,170,137,0.476470588235294,0.353333333333333,0.58125,0.123137254901961
"Chr08","783205","C","A",96,54,150,160,79,84,163,160,0.515337423312883,0.36,0.559105431309904,0.155337423312883
"Chr08","783218","T","C",103,61,164,160,86,84,170,160,0.494117647058824,0.371951219512195,0.565868263473054,0.122166427546628
"Chr08","783308","C","A",90,52,142,160,74,62,136,160,0.455882352941176,0.366197183098592,0.589928057553957,0.0896851698425849
"Chr08","787650","G","A",46,48,94,160,63,57,120,160,0.475,0.51063829787234,0.509345794392523,-0.0356382978723404
"Chr08","787795","T","A",25,13,38,144,26,24,50,144,0.48,0.342105263157895,0.579545454545455,0.137894736842105
"Chr08","788781","A","G",38,36,74,160,32,40,72,160,0.555555555555556,0.486486486486487,0.479452054794521,0.0690690690690691
"Chr08","788891","C","T",49,46,95,142,58,49,107,142,0.457943925233645,0.484210526315789,0.52970297029703,-0.0262666010821446
"Chr08","789012","T","G",35,59,94,147,43,47,90,147,0.522222222222222,0.627659574468085,0.423913043478261,-0.105437352245863
"Chr08","789038","T","G",40,64,104,160,52,44,96,160,0.458333333333333,0.615384615384615,0.46,-0.157051282051282
"Chr08","789056","G","A",42,62,104,156,54,42,96,156,0.4375,0.596153846153846,0.48,-0.158653846153846
"Chr08","789068","T","A",43,63,106,160,52,40,92,160,0.434782608695652,0.594339622641509,0.47979797979798,-0.159557013945857
"Chr08","789077","T","C",40,61,101,160,52,44,96,160,0.458333333333333,0.603960396039604,0.467005076142132,-0.145627062706271
"Chr08","789084","G","A",41,59,100,160,49,46,95,160,0.484210526315789,0.59,0.461538461538462,-0.10578947368421
"Chr08","789107","A","G",43,54,97,139,47,40,87,139,0.459770114942529,0.556701030927835,0.489130434782609,-0.0969309159853063
"Chr08","789124","G","A",36,40,76,147,35,36,71,147,0.507042253521127,0.526315789473684,0.482993197278912,-0.0192735359525574
"Chr08","789134","G","T",33,39,72,146,33,28,61,146,0.459016393442623,0.541666666666667,0.496240601503759,-0.0826502732240437
"Chr08","789180","C","T",25,28,53,160,24,27,51,160,0.529411764705882,0.528301886792453,0.471153846153846,0.00110987791342954
"Chr08","789196","G","T",25,35,60,142,27,35,62,142,0.564516129032258,0.583333333333333,0.426229508196721,-0.0188172043010753
"Chr08","789214","C","T",22,31,53,148,27,34,61,148,0.557377049180328,0.584905660377358,0.429824561403509,-0.0275286111970307
"Chr08","789220","T","C",23,30,53,160,27,29,56,160,0.517857142857143,0.566037735849057,0.458715596330275,-0.0481805929919137
"Chr08","789231","A","T",21,31,52,146,25,28,53,146,0.528301886792453,0.596153846153846,0.438095238095238,-0.0678519593613933
"Chr08","789559","G","A",10,19,29,160,29,24,53,160,0.452830188679245,0.655172413793103,0.475609756097561,-0.202342225113858
"Chr08","789597","C","T",10,17,27,143,28,23,51,143,0.450980392156863,0.62962962962963,0.487179487179487,-0.178649237472767
"Chr08","790069","C","G",15,24,39,160,30,36,66,160,0.545454545454545,0.615384615384615,0.428571428571429,-0.06993006993007
"Chr08","790091","T","A",16,29,45,160,32,30,62,160,0.483870967741935,0.644444444444444,0.448598130841121,-0.160573476702509
"Chr08","791007","G","T",11,24,35,135,14,23,37,148,0.621621621621622,0.685714285714286,0.347222222222222,-0.0640926640926641
"Chr08","791021","T","C",12,25,37,160,17,26,43,160,0.604651162790698,0.675675675675676,0.3625,-0.071024512884978
"Chr08","791026","G","C",12,25,37,160,17,26,43,160,0.604651162790698,0.675675675675676,0.3625,-0.071024512884978
"Chr08","791044","T","C",12,25,37,160,22,26,48,160,0.541666666666667,0.675675675675676,0.4,-0.134009009009009
"Chr08","791251","C","A",36,71,107,139,39,59,98,139,0.602040816326531,0.663551401869159,0.365853658536585,-0.0615105855426282
"Chr08","791258","C","T",39,69,108,143,38,64,102,143,0.627450980392157,0.638888888888889,0.366666666666667,-0.011437908496732
"Chr08","791294","C","G",27,46,73,143,28,43,71,143,0.605633802816901,0.63013698630137,0.381944444444444,-0.0245031834844684
"Chr08","791322","G","A",22,46,68,141,27,46,73,141,0.63013698630137,0.676470588235294,0.347517730496454,-0.0463336019339243
"Chr08","791335","T","C",20,44,64,152,29,42,71,152,0.591549295774648,0.6875,0.362962962962963,-0.0959507042253521
"Chr08","791342","T","C",16,41,57,160,24,42,66,160,0.636363636363636,0.719298245614035,0.32520325203252,-0.0829346092503987
"Chr08","791368","G","C",17,33,50,160,32,36,68,160,0.529411764705882,0.66,0.415254237288136,-0.130588235294118
"Chr08","791378","C","T",21,30,51,160,36,40,76,160,0.526315789473684,0.588235294117647,0.448818897637795,-0.0619195046439629
"Chr08","791454","G","A",36,28,64,147,32,41,73,147,0.561643835616438,0.4375,0.496350364963504,0.124143835616438
"Chr08","791459","C","T",35,28,63,160,32,44,76,160,0.578947368421053,0.444444444444444,0.482014388489209,0.134502923976608
"Chr08","791809","C","T",31,43,74,160,49,33,82,160,0.402439024390244,0.581081081081081,0.512820512820513,-0.178642056690837
"Chr08","792122","G","C",9,5,14,121,12,13,25,160,0.52,0.357142857142857,0.538461538461538,0.162857142857143
"Chr08","792390","G","A",1,10,11,9,14,3,17,38,0.176470588235294,0.909090909090909,0.535714285714286,-0.732620320855615
"Chr08","792720","G","C",7,13,20,142,11,15,26,160,0.576923076923077,0.65,0.391304347826087,-0.0730769230769232
"Chr08","793050","A","G",23,27,50,145,39,45,84,145,0.535714285714286,0.54,0.462686567164179,-0.00428571428571434
"Chr08","793313","G","A",27,32,59,142,38,38,76,142,0.5,0.542372881355932,0.481481481481481,-0.0423728813559322
"Chr08","793318","G","A",28,31,59,145,36,38,74,145,0.513513513513513,0.525423728813559,0.481203007518797,-0.0119102153000459
"Chr08","793557","A","T",29,56,85,160,36,49,85,160,0.576470588235294,0.658823529411765,0.382352941176471,-0.0823529411764706
"Chr08","793820","A","G",41,33,74,141,36,37,73,141,0.506849315068493,0.445945945945946,0.523809523809524,0.0609033691225472
"Chr08","794549","C","T",63,21,84,160,64,83,147,160,0.564625850340136,0.25,0.54978354978355,0.314625850340136
"Chr08","794582","T","C",62,29,91,143,73,85,158,143,0.537974683544304,0.318681318681319,0.542168674698795,0.219293364862985
"Chr08","794728","T","C",53,109,162,160,99,122,221,160,0.552036199095023,0.672839506172839,0.39686684073107,-0.120803307077817
"Chr08","794805","G","A",57,89,146,139,88,126,214,139,0.588785046728972,0.60958904109589,0.402777777777778,-0.0208039943669185
"Chr08","794970","C","T",112,60,172,160,114,98,212,160,0.462264150943396,0.348837209302326,0.588541666666667,0.113426941641071
"Chr08","795327","G","A",75,112,187,160,112,96,208,160,0.461538461538462,0.598930481283422,0.473417721518987,-0.137392019744961
"Chr08","795347","G","T",117,92,209,138,106,107,213,138,0.502347417840376,0.440191387559809,0.528436018957346,0.062156030280567
"Chr08","795373","A","T",74,101,175,138,93,95,188,138,0.50531914893617,0.577142857142857,0.460055096418733,-0.0718237082066869
"Chr08","796466","G","A",26,79,105,160,59,88,147,160,0.598639455782313,0.752380952380952,0.337301587301587,-0.153741496598639
"Chr08","796603","C","T",99,57,156,160,100,85,185,160,0.459459459459459,0.365384615384615,0.583577712609971,0.0940748440748441
"Chr08","796651","G","A",110,71,181,160,118,90,208,160,0.432692307692308,0.392265193370166,0.586118251928021,0.040427114322142
"Chr08","797116","C","T",52,32,84,142,31,41,72,142,0.569444444444444,0.380952380952381,0.532051282051282,0.188492063492063
"Chr08","801570","T","C",77,35,112,160,61,64,125,160,0.512,0.3125,0.582278481012658,0.1995
"Chr08","801583","T","C",74,38,112,160,63,66,129,160,0.511627906976744,0.339285714285714,0.568464730290456,0.17234219269103
"Chr08","801655","C","A",82,42,124,160,71,66,137,160,0.481751824817518,0.338709677419355,0.586206896551724,0.143042147398163
"Chr08","801721","A","G",103,57,160,160,85,94,179,160,0.525139664804469,0.35625,0.554572271386431,0.168889664804469
"Chr08","801795","C","G",93,64,157,160,94,104,198,160,0.525252525252525,0.407643312101911,0.526760563380282,0.117609213150614
"Chr08","801906","C","T",59,87,146,139,89,83,172,139,0.482558139534884,0.595890410958904,0.465408805031447,-0.11333227142402
"Chr08","801962","C","T",104,60,164,141,89,107,196,141,0.545918367346939,0.365853658536585,0.536111111111111,0.180064708810353
"Chr08","802082","T","C",70,48,118,160,66,106,172,160,0.616279069767442,0.406779661016949,0.468965517241379,0.209499408750493
"Chr08","802101","T","C",81,50,131,145,73,105,178,145,0.589887640449438,0.381679389312977,0.498381877022654,0.208208251136461
"Chr08","802160","T","C",86,51,137,160,91,93,184,160,0.505434782608696,0.372262773722628,0.551401869158878,0.133172008886068
"Chr08","802274","T","C",62,49,111,144,88,57,145,144,0.393103448275862,0.441441441441441,0.5859375,-0.0483379931655794
"Chr08","802298","A","T",59,47,106,153,79,49,128,153,0.3828125,0.443396226415094,0.58974358974359,-0.0605837264150944
"Chr08","802299","T","A",46,60,106,143,49,78,127,143,0.614173228346457,0.566037735849057,0.407725321888412,0.0481354924974001
"Chr08","802349","C","A",81,56,137,160,84,59,143,160,0.412587412587413,0.408759124087591,0.589285714285714,0.00382828849982136
"Chr08","802525","C","T",40,53,93,139,75,50,125,139,0.4,0.56989247311828,0.527522935779816,-0.16989247311828
"Chr08","802771","C","T",44,62,106,160,62,50,112,160,0.446428571428571,0.584905660377358,0.486238532110092,-0.138477088948787
"Chr08","803025","T","C",52,38,90,141,45,50,95,141,0.526315789473684,0.422222222222222,0.524324324324324,0.104093567251462
"Chr08","803634","G","A",60,25,85,160,74,75,149,160,0.503355704697987,0.294117647058824,0.572649572649573,0.209238057639163
"Chr08","804245","G","A",18,29,47,139,35,30,65,139,0.461538461538462,0.617021276595745,0.473214285714286,-0.155482815057283
"Chr08","804257","G","A",20,18,38,146,27,30,57,146,0.526315789473684,0.473684210526316,0.494736842105263,0.0526315789473684
"Chr08","805104","C","T",19,2,21,0,20,13,33,142,0.393939393939394,0.0952380952380952,0.722222222222222,0.298701298701299
"Chr08","805525","G","A",20,21,41,160,40,49,89,160,0.550561797752809,0.51219512195122,0.461538461538462,0.0383666758015895
"Chr08","805648","A","T",32,32,64,160,51,34,85,160,0.4,0.5,0.557046979865772,-0.1
"Chr08","805881","C","T",47,79,126,143,66,62,128,143,0.484375,0.626984126984127,0.44488188976378,-0.142609126984127
"Chr08","808221","C","T",101,50,151,140,87,96,183,140,0.524590163934426,0.33112582781457,0.562874251497006,0.193464336119857
"Chr08","809360","A","T",19,28,47,160,31,29,60,160,0.483333333333333,0.595744680851064,0.467289719626168,-0.11241134751773
"Chr08","809957","G","A",76,50,126,160,74,82,156,160,0.525641025641026,0.396825396825397,0.531914893617021,0.128815628815629
"Chr08","810751","G","A",82,50,132,160,77,73,150,160,0.486666666666667,0.378787878787879,0.563829787234043,0.107878787878788
"Chr08","811537","A","G",65,93,158,138,111,89,200,138,0.445,0.588607594936709,0.491620111731844,-0.143607594936709
"Chr08","811968","G","A",105,75,180,160,92,87,179,160,0.486033519553073,0.416666666666667,0.54874651810585,0.0693668528864059
"Chr08","813409","G","C",43,16,59,146,37,26,63,146,0.412698412698413,0.271186440677966,0.655737704918033,0.141511972020447
"Chr08","813489","A","G",38,19,57,145,45,28,73,145,0.383561643835616,0.333333333333333,0.638461538461538,0.0502283105022831
"Chr08","813533","T","G",45,40,85,160,48,44,92,160,0.478260869565217,0.470588235294118,0.525423728813559,0.00767263427109977
"Chr08","813772","G","A",87,40,127,160,67,67,134,160,0.5,0.31496062992126,0.590038314176245,0.18503937007874
"Chr08","813779","T","C",90,40,130,160,69,66,135,160,0.488888888888889,0.307692307692308,0.6,0.181196581196581
"Chr08","813810","A","G",106,48,154,160,88,80,168,160,0.476190476190476,0.311688311688312,0.602484472049689,0.164502164502164
"Chr08","814683","C","A",58,92,150,136,108,98,206,136,0.475728155339806,0.613333333333333,0.466292134831461,-0.137605177993527
"Chr08","814771","C","A",110,55,165,146,112,99,211,146,0.469194312796209,0.333333333333333,0.590425531914894,0.135860979462875
"Chr08","814825","G","C",73,139,212,160,145,140,285,160,0.491228070175439,0.655660377358491,0.438631790744467,-0.164432307183052
"Chr08","814967","C","T",148,94,242,160,122,174,296,160,0.587837837837838,0.388429752066116,0.50185873605948,0.199408085771722
"Chr08","815054","C","G",75,114,189,160,134,123,257,160,0.478599221789883,0.603174603174603,0.468609865470852,-0.12457538138472
"Chr08","815113","C","T",84,58,142,160,126,119,245,160,0.485714285714286,0.408450704225352,0.542635658914729,0.0772635814889336
"Chr08","815783","C","T",112,83,195,140,114,102,216,140,0.472222222222222,0.425641025641026,0.549878345498783,0.0465811965811966
"Chr08","817367","T","C",37,54,91,141,52,70,122,141,0.573770491803279,0.593406593406593,0.417840375586854,-0.0196361016033147
"Chr08","818537","T","C",42,25,67,143,58,43,101,143,0.425742574257426,0.373134328358209,0.595238095238095,0.0526082458992168
"Chr08","818544","G","T",37,26,63,160,61,44,105,160,0.419047619047619,0.412698412698413,0.583333333333333,0.00634920634920638
"Chr08","818563","C","T",25,35,60,141,49,60,109,141,0.55045871559633,0.583333333333333,0.437869822485207,-0.0328746177370031
"Chr08","818570","T","C",35,25,60,146,60,49,109,146,0.44954128440367,0.416666666666667,0.562130177514793,0.0328746177370031
"Chr08","818695","A","G",74,35,109,160,55,50,105,160,0.476190476190476,0.321100917431193,0.602803738317757,0.155089558759283
"Chr08","818700","A","G",35,75,110,142,51,57,108,142,0.527777777777778,0.681818181818182,0.394495412844037,-0.154040404040404
"Chr08","818739","A","G",33,64,97,139,45,49,94,139,0.521276595744681,0.65979381443299,0.408376963350785,-0.138517218688309
"Chr08","818742","C","T",64,34,98,160,50,45,95,160,0.473684210526316,0.346938775510204,0.590673575129534,0.126745435016112
"Chr08","818825","C","A",59,25,84,154,58,52,110,154,0.472727272727273,0.297619047619048,0.603092783505155,0.175108225108225
"Chr08","818934","A","T",47,82,129,137,99,76,175,137,0.434285714285714,0.635658914728682,0.480263157894737,-0.201373200442968
"Chr08","818937","T","C",80,49,129,136,76,100,176,136,0.568181818181818,0.37984496124031,0.511475409836066,0.188336856941508
"Chr08","818944","G","A",74,45,119,143,64,95,159,143,0.59748427672956,0.378151260504202,0.496402877697842,0.219333016225358
"Chr08","818999","G","A",64,33,97,140,56,83,139,140,0.597122302158273,0.34020618556701,0.508474576271186,0.256916116591263
"Chr08","819004","G","A",60,33,93,160,53,81,134,160,0.604477611940298,0.354838709677419,0.497797356828194,0.249638902262879
"Chr08","822430","A","G",104,43,147,140,79,91,170,140,0.535294117647059,0.292517006802721,0.577287066246057,0.242777110844338
"Chr08","826247","C","G",87,51,138,139,76,69,145,139,0.475862068965517,0.369565217391304,0.575971731448763,0.106296851574213
"Chr08","826307","G","A",72,44,116,160,67,56,123,160,0.455284552845528,0.379310344827586,0.581589958158996,0.0759742080179422
"Chr08","826342","C","T",61,38,99,160,55,61,116,160,0.525862068965517,0.383838383838384,0.53953488372093,0.142023685127133
"Chr08","826384","A","G",68,35,103,160,56,52,108,160,0.481481481481481,0.339805825242718,0.587677725118483,0.141675656238763
"Chr08","826419","C","T",62,27,89,160,57,55,112,160,0.491071428571429,0.303370786516854,0.592039800995025,0.187700642054575
"Chr08","826433","A","T",30,59,89,140,56,60,116,140,0.517241379310345,0.662921348314607,0.419512195121951,-0.145679969004262
"Chr08","826436","C","A",60,30,90,151,62,57,119,151,0.478991596638655,0.333333333333333,0.583732057416268,0.145658263305322
"Chr08","826443","C","G",60,29,89,145,61,53,114,145,0.464912280701754,0.325842696629214,0.596059113300493,0.139069584072541
"Chr08","826455","C","G",60,26,86,160,62,51,113,160,0.451327433628319,0.302325581395349,0.613065326633166,0.14900185223297
"Chr08","826619","C","G",90,81,171,160,70,81,151,160,0.536423841059603,0.473684210526316,0.496894409937888,0.0627396305332868
"Chr08","827566","C","T",59,49,108,160,62,98,160,160,0.6125,0.453703703703704,0.451492537313433,0.158796296296296
"Chr08","827705","C","T",69,45,114,143,78,65,143,143,0.454545454545455,0.394736842105263,0.571984435797665,0.0598086124401914
"Chr08","827716","C","T",61,43,104,139,82,70,152,139,0.460526315789474,0.413461538461538,0.55859375,0.0470647773279352
"Chr08","827753","T","C",63,34,97,141,65,74,139,141,0.532374100719424,0.350515463917526,0.542372881355932,0.181858636801899
"Chr08","827919","T","C",64,58,122,160,72,108,180,160,0.6,0.475409836065574,0.450331125827815,0.124590163934426
"Chr08","828016","C","A",57,55,112,143,76,96,172,143,0.558139534883721,0.491071428571429,0.46830985915493,0.0670681063122924
"Chr08","828046","T","A",56,65,121,160,73,95,168,160,0.56547619047619,0.537190082644628,0.44636678200692,0.0282861078315624
"Chr08","828218","A","G",36,37,73,160,25,42,67,160,0.626865671641791,0.506849315068493,0.435714285714286,0.120016356573298
"Chr08","828302","T","A",48,35,83,140,27,48,75,140,0.64,0.421686746987952,0.474683544303797,0.218313253012048
"Chr08","828337","G","A",43,28,71,160,23,33,56,160,0.589285714285714,0.394366197183099,0.519685039370079,0.194919517102616
"Chr08","828345","T","A",41,25,66,160,23,31,54,160,0.574074074074074,0.378787878787879,0.533333333333333,0.195286195286195
"Chr08","828454","T","C",29,16,45,160,31,18,49,160,0.36734693877551,0.355555555555556,0.638297872340426,0.0117913832199547
"Chr08","828575","T","C",23,20,43,160,18,19,37,160,0.513513513513513,0.465116279069767,0.5125,0.0483972344437461
"Chr08","828581","C","T",24,19,43,160,16,19,35,160,0.542857142857143,0.441860465116279,0.512820512820513,0.100996677740864
"Chr08","828685","A","T",12,5,17,94,5,11,16,96,0.6875,0.294117647058824,0.515151515151515,0.393382352941176
"Chr08","829107","G","A",47,34,81,140,46,41,87,140,0.471264367816092,0.419753086419753,0.553571428571429,0.0515112813963389
"Chr08","829280","A","T",42,69,111,160,76,103,179,160,0.575418994413408,0.621621621621622,0.406896551724138,-0.0462026272082138
"Chr08","829295","G","C",47,65,112,141,72,94,166,141,0.566265060240964,0.580357142857143,0.428057553956835,-0.014092082616179
"Chr08","829308","G","C",56,56,112,160,70,85,155,160,0.548387096774194,0.5,0.471910112359551,0.0483870967741935
"Chr08","829653","G","T",78,62,140,146,116,94,210,146,0.447619047619048,0.442857142857143,0.554285714285714,0.0047619047619048
"Chr08","829787","C","G",77,115,192,160,118,125,243,160,0.51440329218107,0.598958333333333,0.448275862068966,-0.0845550411522634
"Chr08","829960","A","G",63,107,170,160,67,94,161,160,0.583850931677019,0.629411764705882,0.392749244712991,-0.0455608330288637
"Chr08","830141","G","T",118,98,216,140,145,143,288,140,0.496527777777778,0.453703703703704,0.521825396825397,0.0428240740740741
"Chr08","830158","A","T",100,123,223,140,151,151,302,140,0.5,0.551569506726457,0.478095238095238,-0.0515695067264574
"Chr08","830278","A","G",84,148,232,138,124,140,264,138,0.53030303030303,0.637931034482759,0.419354838709677,-0.107628004179728
"Chr08","830297","C","T",74,145,219,145,116,129,245,145,0.526530612244898,0.662100456621005,0.40948275862069,-0.135569844376107
"Chr08","830326","C","A",75,149,224,139,97,122,219,139,0.557077625570776,0.665178571428571,0.388261851015801,-0.108100945857795
"Chr08","830348","C","G",144,91,235,144,135,120,255,144,0.470588235294118,0.387234042553191,0.569387755102041,0.0833541927409261
"Chr08","835936","C","T",18,22,40,143,30,24,54,143,0.444444444444444,0.55,0.51063829787234,-0.105555555555556
"Chr08","836011","C","T",22,31,53,160,40,45,85,160,0.529411764705882,0.584905660377358,0.449275362318841,-0.0554938956714761
"Chr08","836038","C","T",20,30,50,160,33,41,74,160,0.554054054054054,0.6,0.42741935483871,-0.0459459459459459
"Chr08","838161","A","T",41,70,111,160,57,87,144,160,0.604166666666667,0.630630630630631,0.384313725490196,-0.026463963963964
"Chr08","838333","C","T",60,47,107,160,63,50,113,160,0.442477876106195,0.439252336448598,0.559090909090909,0.00322553965759659
"Chr08","838585","G","C",68,52,120,160,83,67,150,160,0.446666666666667,0.433333333333333,0.559259259259259,0.0133333333333333
"Chr08","839634","G","A",58,35,93,146,60,45,105,146,0.428571428571429,0.376344086021505,0.595959595959596,0.0522273425499232
"Chr08","839809","C","T",99,62,161,160,71,79,150,160,0.526666666666667,0.385093167701863,0.546623794212219,0.141573498964803
"Chr08","841645","A","C",47,27,74,160,53,38,91,160,0.417582417582418,0.364864864864865,0.606060606060606,0.0527175527175527
"Chr08","843150","G","A",36,24,60,160,48,54,102,160,0.529411764705882,0.4,0.518518518518518,0.129411764705882
"Chr08","843223","G","A",27,50,77,141,47,47,94,141,0.5,0.649350649350649,0.432748538011696,-0.149350649350649
"Chr08","843737","C","A",64,44,108,142,65,53,118,142,0.449152542372881,0.407407407407407,0.570796460176991,0.041745134965474
"Chr08","844735","T","C",102,66,168,140,74,107,181,140,0.591160220994475,0.392857142857143,0.504297994269341,0.198303078137332
"Chr08","845389","G","A",99,64,163,136,107,112,219,136,0.511415525114155,0.392638036809816,0.539267015706806,0.118777488304339
"Chr08","845509","C","A",86,48,134,146,80,94,174,146,0.540229885057471,0.358208955223881,0.538961038961039,0.182020929833591
"Chr08","845777","G","A",71,54,125,160,75,92,167,160,0.550898203592814,0.432,0.5,0.118898203592814
"Chr08","845785","A","G",68,54,122,160,74,84,158,160,0.531645569620253,0.442622950819672,0.507142857142857,0.089022618800581
"Chr08","845825","G","C",57,63,120,143,52,55,107,143,0.514018691588785,0.525,0.480176211453745,-0.010981308411215
"Chr08","845906","A","G",84,61,145,137,61,82,143,137,0.573426573426573,0.420689655172414,0.503472222222222,0.15273691825416
"Chr08","846657","C","T",53,82,135,160,118,116,234,160,0.495726495726496,0.607407407407407,0.463414634146341,-0.111680911680912
"Chr08","847273","A","G",25,32,57,160,31,48,79,160,0.607594936708861,0.56140350877193,0.411764705882353,0.046191427936931
"Chr08","848080","G","T",28,32,60,150,36,41,77,150,0.532467532467532,0.533333333333333,0.467153284671533,-0.000865800865800903
"Chr08","848330","C","T",37,20,57,147,44,25,69,147,0.36231884057971,0.350877192982456,0.642857142857143,0.011441647597254
"Chr08","848652","A","T",38,19,57,146,49,41,90,146,0.455555555555556,0.333333333333333,0.591836734693878,0.122222222222222
"Chr08","848851","C","T",21,34,55,144,46,30,76,144,0.394736842105263,0.618181818181818,0.511450381679389,-0.223444976076555
"Chr08","848938","G","A",25,50,75,160,61,47,108,160,0.435185185185185,0.666666666666667,0.469945355191257,-0.231481481481481
"Chr08","849515","C","G",121,47,168,160,106,88,194,160,0.45360824742268,0.279761904761905,0.62707182320442,0.173846342660776
"Chr08","849621","A","T",33,55,88,140,37,44,81,140,0.54320987654321,0.625,0.414201183431953,-0.0817901234567902
"Chr08","856444","T","C",26,18,44,160,22,30,52,160,0.576923076923077,0.409090909090909,0.5,0.167832167832168
"Chr08","856814","C","G",22,46,68,139,38,48,86,139,0.558139534883721,0.676470588235294,0.38961038961039,-0.118331053351573
"Chr08","858003","G","T",72,90,162,160,84,92,176,160,0.522727272727273,0.555555555555556,0.461538461538462,-0.0328282828282829
"Chr08","858964","T","G",100,55,155,134,92,96,188,134,0.51063829787234,0.354838709677419,0.559766763848397,0.155799588194921
"Chr08","859202","A","C",86,113,199,142,106,105,211,142,0.497630331753554,0.5678391959799,0.468292682926829,-0.070208864226345
"Chr08","866958","C","T",40,26,66,144,36,17,53,144,0.320754716981132,0.393939393939394,0.638655462184874,-0.0731846769582619
"Chr08","867582","G","A",19,45,64,144,31,23,54,144,0.425925925925926,0.703125,0.423728813559322,-0.277199074074074
"Chr08","868344","T","C",47,84,131,160,71,81,152,160,0.532894736842105,0.641221374045801,0.416961130742049,-0.108326637203696
"Chr08","869651","C","G",22,45,67,151,28,52,80,151,0.65,0.671641791044776,0.340136054421769,-0.0216417910447761
"Chr08","869895","C","T",62,29,91,143,48,36,84,143,0.428571428571429,0.318681318681319,0.628571428571429,0.10989010989011
"Chr08","872030","C","T",48,79,127,139,94,69,163,139,0.423312883435583,0.622047244094488,0.489655172413793,-0.198734360658905
"Chr08","872181","G","A",95,74,169,160,85,72,157,160,0.45859872611465,0.437869822485207,0.552147239263804,0.0207289036294426
"Chr08","872555","C","A",66,85,151,160,82,92,174,160,0.528735632183908,0.562913907284768,0.455384615384615,-0.0341782751008601
"Chr08","873315","A","G",99,66,165,136,91,101,192,136,0.526041666666667,0.4,0.532212885154062,0.126041666666667
"Chr08","874800","G","T",35,72,107,155,80,56,136,155,0.411764705882353,0.672897196261682,0.473251028806584,-0.261132490379329
"Chr08","875014","G","A",40,98,138,160,70,56,126,160,0.444444444444444,0.710144927536232,0.416666666666667,-0.265700483091788
"Chr08","875181","T","C",28,74,102,160,55,69,124,160,0.556451612903226,0.725490196078431,0.367256637168142,-0.169038583175206
"Chr08","875710","TTT","TTC",24,14,38,160,35,29,64,160,0.453125,0.368421052631579,0.57843137254902,0.0847039473684211
"Chr08","875726","C","G",14,22,36,155,24,35,59,155,0.593220338983051,0.611111111111111,0.4,-0.0178907721280603
"Chr08","875968","A","G",9,22,31,142,10,13,23,160,0.565217391304348,0.709677419354839,0.351851851851852,-0.144460028050491
"Chr08","875996","G","T",7,17,24,143,7,13,20,129,0.65,0.708333333333333,0.318181818181818,-0.0583333333333333
"Chr08","883021","A","G",54,20,74,144,55,41,96,144,0.427083333333333,0.27027027027027,0.641176470588235,0.156813063063063
"Chr08","883029","T","C",53,22,75,149,52,41,93,149,0.440860215053763,0.293333333333333,0.625,0.14752688172043
"Chr08","883074","G","A",62,26,88,160,60,53,113,160,0.469026548672566,0.295454545454545,0.606965174129353,0.173572003218021
"Chr08","883249","A","G",33,17,50,160,38,40,78,160,0.512820512820513,0.34,0.5546875,0.172820512820513
"Chr08","883495","C","A",52,70,122,160,37,89,126,160,0.706349206349206,0.573770491803279,0.358870967741935,0.132578714545928
"Chr08","883521","A","G",38,35,73,160,49,22,71,160,0.309859154929577,0.479452054794521,0.604166666666667,-0.169592899864943
"Chr08","885367","C","T",55,32,87,160,47,76,123,160,0.617886178861789,0.367816091954023,0.485714285714286,0.250070086907766
"Chr08","885375","G","A",57,33,90,160,52,80,132,160,0.606060606060606,0.366666666666667,0.490990990990991,0.239393939393939
"Chr08","885383","A","C",59,35,94,139,53,84,137,139,0.613138686131387,0.372340425531915,0.484848484848485,0.240798260599472
"Chr08","885398","A","G",69,37,106,160,60,86,146,160,0.589041095890411,0.349056603773585,0.511904761904762,0.239984492116826
"Chr08","885473","T","G",41,81,122,136,100,70,170,136,0.411764705882353,0.663934426229508,0.482876712328767,-0.252169720347155
"Chr08","885560","C","T",44,14,58,160,53,38,91,160,0.417582417582418,0.241379310344828,0.651006711409396,0.17620310723759
"Chr08","885624","G","C",49,35,84,138,57,54,111,138,0.486486486486487,0.416666666666667,0.543589743589744,0.0698198198198198
"Chr08","885696","A","G",59,48,107,160,53,77,130,160,0.592307692307692,0.448598130841121,0.472573839662447,0.143709561466571
"Chr08","885763","A","G",74,58,132,160,70,84,154,160,0.545454545454545,0.439393939393939,0.503496503496504,0.106060606060606
"Chr08","885776","G","T",76,59,135,160,70,86,156,160,0.551282051282051,0.437037037037037,0.501718213058419,0.114245014245014
"Chr08","885800","A","T",56,80,136,160,81,75,156,160,0.480769230769231,0.588235294117647,0.469178082191781,-0.107466063348416
"Chr08","885855","T","A",70,52,122,139,68,80,148,139,0.540540540540541,0.426229508196721,0.511111111111111,0.114311032343819
"Chr08","886267","T","A",83,62,145,142,65,86,151,142,0.56953642384106,0.427586206896552,0.5,0.141950216944508
"Chr08","886357","G","A",82,45,127,145,72,81,153,145,0.529411764705882,0.354330708661417,0.55,0.175081056044465
"Chr08","886393","A","G",78,39,117,160,71,86,157,160,0.547770700636943,0.333333333333333,0.543795620437956,0.214437367303609
"Chr08","886479","G","C",77,41,118,160,67,83,150,160,0.553333333333333,0.347457627118644,0.537313432835821,0.205875706214689
"Chr08","886632","C","T",78,22,100,160,54,67,121,160,0.553719008264463,0.22,0.597285067873303,0.333719008264463
"Chr08","886656","A","G",77,23,100,146,58,68,126,146,0.53968253968254,0.23,0.597345132743363,0.30968253968254
"Chr08","886686","T","C",70,16,86,160,49,64,113,160,0.566371681415929,0.186046511627907,0.597989949748744,0.380325169788022
"Chr08","886705","A","G",18,69,87,139,62,42,104,139,0.403846153846154,0.793103448275862,0.418848167539267,-0.389257294429708
"Chr08","886826","T","G",32,22,54,145,32,37,69,145,0.536231884057971,0.407407407407407,0.520325203252033,0.128824476650564
"Chr08","886935","T","C",25,15,40,142,26,48,74,142,0.648648648648649,0.375,0.447368421052632,0.273648648648649
"Chr08","887089","C","T",25,22,47,144,30,54,84,144,0.642857142857143,0.468085106382979,0.419847328244275,0.174772036474164
"Chr08","887241","A","G",41,26,67,160,46,64,110,160,0.581818181818182,0.388059701492537,0.491525423728814,0.193758480325644
"Chr08","887264","A","G",46,27,73,160,50,66,116,160,0.568965517241379,0.36986301369863,0.507936507936508,0.199102503542749
"Chr08","887270","G","A",46,28,74,160,54,67,121,160,0.553719008264463,0.378378378378378,0.512820512820513,0.175340629886084
"Chr08","887292","A","G",51,27,78,147,61,63,124,147,0.508064516129032,0.346153846153846,0.554455445544555,0.161910669975186
"Chr08","887369","T","C",55,30,85,145,56,48,104,145,0.461538461538462,0.352941176470588,0.587301587301587,0.108597285067873
"Chr08","887390","T","C",68,31,99,160,61,50,111,160,0.45045045045045,0.313131313131313,0.614285714285714,0.137319137319137
"Chr08","887395","T","C",70,32,102,152,61,54,115,152,0.469565217391304,0.313725490196078,0.603686635944701,0.155839727195226
"Chr08","887401","T","C",73,36,109,160,64,51,115,160,0.443478260869565,0.330275229357798,0.611607142857143,0.113203031511767
"Chr08","887441","C","T",76,42,118,160,66,60,126,160,0.476190476190476,0.355932203389831,0.581967213114754,0.120258272800646
"Chr08","887734","C","T",48,32,80,160,56,56,112,160,0.5,0.4,0.541666666666667,0.1
"Chr08","887761","A","G",48,33,81,143,59,50,109,143,0.458715596330275,0.407407407407407,0.563157894736842,0.0513081889228679
"Chr08","887990","C","T",56,43,99,160,94,53,147,160,0.360544217687075,0.434343434343434,0.609756097560976,-0.0737992166563595
"Chr08","888019","G","A",53,41,94,142,83,58,141,142,0.411347517730496,0.436170212765957,0.578723404255319,-0.024822695035461
"Chr08","888043","A","C",49,44,93,160,55,61,116,160,0.525862068965517,0.473118279569892,0.497607655502392,0.0527437893956247
"Chr08","888048","G","A",41,42,83,160,43,59,102,160,0.57843137254902,0.506024096385542,0.454054054054054,0.0724072761634775
"Chr08","888115","G","C",46,49,95,160,49,67,116,160,0.577586206896552,0.515789473684211,0.450236966824645,0.0617967332123411
"Chr08","888120","G","A",54,49,103,160,56,70,126,160,0.555555555555556,0.475728155339806,0.480349344978166,0.0798274002157497
"Chr08","888140","C","T",50,40,90,160,49,67,116,160,0.577586206896552,0.444444444444444,0.480582524271845,0.133141762452107
"Chr08","888194","C","T",61,32,93,160,55,61,116,160,0.525862068965517,0.344086021505376,0.555023923444976,0.181776047460141
"Chr08","888238","T","C",58,29,87,160,66,46,112,160,0.410714285714286,0.333333333333333,0.623115577889447,0.0773809523809524
"Chr08","888245","A","G",29,58,87,160,44,66,110,160,0.6,0.666666666666667,0.370558375634518,-0.0666666666666667
"Chr08","888246","G","A",58,29,87,160,66,44,110,160,0.4,0.333333333333333,0.629441624365482,0.0666666666666667
"Chr08","888268","A","C",69,36,105,146,76,53,129,146,0.410852713178295,0.342857142857143,0.61965811965812,0.0679955703211517
"Chr08","888297","T","C",71,37,108,160,80,57,137,160,0.416058394160584,0.342592592592593,0.616326530612245,0.0734658015679913
"Chr08","888324","C","T",67,36,103,160,80,53,133,160,0.398496240601504,0.349514563106796,0.622881355932203,0.0489816774947076
"Chr08","888405","C","T",76,57,133,138,71,80,151,138,0.529801324503311,0.428571428571429,0.517605633802817,0.101229895931883
"Chr08","888425","G","T",57,63,120,144,55,68,123,144,0.552845528455285,0.525,0.460905349794239,0.0278455284552845
"Chr08","888446","T","A",61,61,122,160,51,66,117,160,0.564102564102564,0.5,0.468619246861925,0.0641025641025641
"Chr08","888461","G","A",68,70,138,142,53,67,120,142,0.558333333333333,0.507246376811594,0.468992248062016,0.0510869565217391
"Chr08","888467","A","G",69,70,139,144,54,68,122,144,0.557377049180328,0.503597122302158,0.471264367816092,0.0537799268781696
"Chr08","888506","C","A",73,71,144,142,67,77,144,142,0.534722222222222,0.493055555555556,0.486111111111111,0.0416666666666666
"Chr08","888524","C","T",72,68,140,160,67,78,145,160,0.537931034482759,0.485714285714286,0.487719298245614,0.0522167487684729
"Chr08","888564","G","A",64,50,114,160,65,63,128,160,0.4921875,0.43859649122807,0.533057851239669,0.0535910087719298
"Chr08","888582","A","G",51,37,88,160,60,69,129,160,0.534883720930233,0.420454545454545,0.511520737327189,0.114429175475687
"Chr08","888661","T","C",65,42,107,160,87,70,157,160,0.445859872611465,0.392523364485981,0.575757575757576,0.0533365081254837
"Chr08","888673","G","A",39,60,99,160,67,79,146,160,0.541095890410959,0.606060606060606,0.43265306122449,-0.0649647156496471
"Chr08","888692","C","T",74,49,123,156,93,73,166,156,0.439759036144578,0.398373983739837,0.577854671280277,0.0413850524047409
"Chr08","888699","A","G",77,53,130,160,92,70,162,160,0.432098765432099,0.407692307692308,0.578767123287671,0.0244064577397911
"Chr08","888713","C","T",78,59,137,141,92,72,164,141,0.439024390243902,0.430656934306569,0.564784053156146,0.00836745593733312
"Chr08","888794","C","A",92,72,164,137,78,74,152,137,0.486842105263158,0.439024390243902,0.537974683544304,0.0478177150192555
"Chr08","888807","A","G",93,68,161,140,72,72,144,140,0.5,0.422360248447205,0.540983606557377,0.077639751552795
"Chr08","888874","T","C",102,66,168,160,89,77,166,160,0.463855421686747,0.392857142857143,0.57185628742515,0.0709982788296041
"Chr08","888939","C","A",78,63,141,143,91,75,166,143,0.451807228915663,0.446808510638298,0.550488599348534,0.00499871827736481
"Chr08","888944","A","G",84,64,148,138,97,76,173,138,0.439306358381503,0.432432432432432,0.56386292834891,0.00687392594907044
"Chr08","888985","C","T",88,83,171,160,102,102,204,160,0.5,0.485380116959064,0.506666666666667,0.0146198830409357
"Chr08","888993","G","A",84,83,167,160,109,104,213,160,0.488262910798122,0.497005988023952,0.507894736842105,-0.00874307722583001
"Chr08","889284","T","C",96,76,172,136,96,82,178,136,0.460674157303371,0.441860465116279,0.548571428571429,0.0188136921870917
"Chr08","889335","A","G",99,76,175,160,93,88,181,160,0.486187845303867,0.434285714285714,0.539325842696629,0.0519021310181531
"Chr08","889451","T","A",111,54,165,160,121,118,239,160,0.493723849372385,0.327272727272727,0.574257425742574,0.166451122099658
"Chr08","889517","G","T",112,76,188,139,123,131,254,139,0.515748031496063,0.404255319148936,0.531674208144796,0.111492712347127
"Chr08","889659","C","T",34,86,120,106,60,65,125,136,0.52,0.716666666666667,0.383673469387755,-0.196666666666667
"Chr08","889660","A","C",86,34,120,78,66,59,125,137,0.472,0.283333333333333,0.620408163265306,0.188666666666667
"Chr08","889777","C","T",116,58,174,160,91,105,196,160,0.535714285714286,0.333333333333333,0.559459459459459,0.202380952380952
"Chr08","889953","A","C",62,40,102,160,70,36,106,160,0.339622641509434,0.392156862745098,0.634615384615385,-0.0525342212356641
"Chr08","889965","C","G",61,44,105,160,65,46,111,160,0.414414414414414,0.419047619047619,0.583333333333333,-0.00463320463320466
"Chr08","890040","A","G",65,36,101,160,71,51,122,160,0.418032786885246,0.356435643564356,0.609865470852018,0.0615971433208895
"Chr08","890242","G","A",62,46,108,160,67,48,115,160,0.417391304347826,0.425925925925926,0.57847533632287,-0.00853462157809987
"Chr08","891534","A","G",74,36,110,138,64,76,140,138,0.542857142857143,0.327272727272727,0.552,0.215584415584416
"Chr08","891572","C","T",76,47,123,160,69,76,145,160,0.524137931034483,0.382113821138211,0.541044776119403,0.142024109896271
"Chr08","891731","T","A",67,37,104,140,61,54,115,140,0.469565217391304,0.355769230769231,0.584474885844749,0.113795986622074
"Chr08","891765","T","G",68,41,109,140,60,63,123,140,0.51219512195122,0.376146788990826,0.551724137931034,0.136048332960394
"Chr08","891778","A","G",68,39,107,142,66,60,126,142,0.476190476190476,0.364485981308411,0.575107296137339,0.111704494882065
"Chr08","891786","T","C",69,37,106,146,61,58,119,146,0.487394957983193,0.349056603773585,0.577777777777778,0.138338354209608
"Chr08","891828","T","A",61,39,100,160,50,51,101,160,0.504950495049505,0.39,0.552238805970149,0.114950495049505
"Chr08","892014","G","C",22,19,41,143,41,44,85,143,0.517647058823529,0.463414634146341,0.5,0.054232424677188
"Chr08","892042","T","C",31,22,53,141,43,51,94,141,0.542553191489362,0.415094339622642,0.503401360544218,0.12745885186672
"Chr08","892696","G","C",15,12,27,157,12,11,23,157,0.478260869565217,0.444444444444444,0.54,0.033816425120773
"Chr08","892823","T","C",30,36,66,160,40,23,63,160,0.365079365079365,0.545454545454545,0.542635658914729,-0.18037518037518
"Chr08","892885","G","T",32,37,69,160,42,34,76,160,0.447368421052632,0.536231884057971,0.510344827586207,-0.0888634630053395
"Chr08","892904","G","A",37,36,73,160,37,42,79,160,0.531645569620253,0.493150684931507,0.486842105263158,0.0384948846887463
"Chr08","892966","T","C",28,24,52,160,41,52,93,160,0.559139784946237,0.461538461538462,0.475862068965517,0.0976013234077749
"Chr08","893023","A","C",56,42,98,139,68,64,132,139,0.484848484848485,0.428571428571429,0.539130434782609,0.0562770562770563
"Chr08","893057","T","C",51,54,105,160,72,61,133,160,0.458646616541353,0.514285714285714,0.516806722689076,-0.0556390977443609
"Chr08","893172","G","A",72,34,106,160,61,52,113,160,0.460176991150442,0.320754716981132,0.607305936073059,0.13942227416931
"Chr08","893401","A","T",90,55,145,160,78,82,160,160,0.5125,0.379310344827586,0.550819672131148,0.133189655172414
"Chr08","893492","C","T",104,54,158,160,89,73,162,160,0.450617283950617,0.341772151898734,0.603125,0.108845132051883
"Chr08","893497","T","C",101,54,155,160,89,70,159,160,0.440251572327044,0.348387096774194,0.605095541401274,0.0918644755528505
"Chr08","893537","T","C",105,64,169,160,98,77,175,160,0.44,0.378698224852071,0.590116279069767,0.061301775147929
"Chr08","893560","G","A",110,66,176,160,102,78,180,160,0.433333333333333,0.375,0.595505617977528,0.0583333333333333
"Chr08","893585","G","C",107,62,169,136,95,76,171,136,0.444444444444444,0.366863905325444,0.594117647058824,0.0775805391190006
"Chr08","893593","C","T",110,65,175,160,100,80,180,160,0.444444444444444,0.371428571428571,0.591549295774648,0.073015873015873
"Chr08","893608","G","A",113,58,171,137,83,88,171,137,0.514619883040936,0.339181286549708,0.573099415204678,0.175438596491228
"Chr08","893629","T","C",114,51,165,143,74,86,160,143,0.5375,0.309090909090909,0.578461538461538,0.228409090909091
"Chr08","893651","T","C",101,51,152,141,82,79,161,141,0.490683229813665,0.335526315789474,0.584664536741214,0.155156914024191
"Chr08","893686","A","G",117,55,172,160,83,80,163,160,0.49079754601227,0.319767441860465,0.597014925373134,0.171030104151805
"Chr08","893759","G","A",99,63,162,160,102,85,187,160,0.454545454545455,0.388888888888889,0.575931232091691,0.0656565656565656
"Chr08","893819","T","G",87,45,132,139,93,82,175,139,0.468571428571429,0.340909090909091,0.586319218241042,0.127662337662338
"Chr08","893839","A","G",89,37,126,140,80,74,154,140,0.480519480519481,0.293650793650794,0.603571428571429,0.186868686868687
"Chr08","894024","C","A",95,58,153,160,79,87,166,160,0.524096385542169,0.379084967320261,0.545454545454545,0.145011418221907
"Chr08","894054","C","T",92,58,150,137,89,86,175,137,0.491428571428571,0.386666666666667,0.556923076923077,0.104761904761905
"Chr08","894071","T","C",93,60,153,160,90,81,171,160,0.473684210526316,0.392156862745098,0.564814814814815,0.0815273477812177
"Chr08","894181","C","T",113,77,190,137,101,110,211,137,0.52132701421801,0.405263157894737,0.533665835411471,0.116063856323273
"Chr08","894191","A","T",113,77,190,136,97,113,210,136,0.538095238095238,0.405263157894737,0.525,0.132832080200501
"Chr08","894204","C","T",112,76,188,144,97,113,210,144,0.538095238095238,0.404255319148936,0.525125628140704,0.133839918946302
"Chr08","894272","G","A",73,46,119,142,86,94,180,142,0.522222222222222,0.38655462184874,0.531772575250836,0.135667600373483
"Chr08","894348","A","C",75,61,136,160,74,82,156,160,0.525641025641026,0.448529411764706,0.51027397260274,0.0771116138763198
"Chr08","894389","C","T",99,69,168,160,81,82,163,160,0.503067484662577,0.410714285714286,0.54380664652568,0.092353198948291
"Chr08","894400","C","T",100,72,172,160,87,89,176,160,0.505681818181818,0.418604651162791,0.53735632183908,0.0870771670190275
"Chr08","894409","G","A",109,75,184,160,99,97,196,160,0.494897959183673,0.407608695652174,0.547368421052632,0.0872892635314996
"Chr08","894569","C","T",129,72,201,151,117,120,237,151,0.506329113924051,0.358208955223881,0.561643835616438,0.14812015870017
"Chr08","894592","C","G",127,68,195,139,110,125,235,139,0.531914893617021,0.348717948717949,0.551162790697674,0.183196944899073
"Chr08","894648","C","T",87,50,137,160,88,103,191,160,0.539267015706806,0.364963503649635,0.533536585365854,0.174303512057171
"Chr08","894704","G","A",76,47,123,160,67,62,129,160,0.48062015503876,0.382113821138211,0.567460317460317,0.0985063339005483
"Chr08","894709","C","T",80,45,125,149,65,63,128,149,0.4921875,0.36,0.573122529644269,0.1321875
"Chr08","894723","T","C",78,39,117,160,71,57,128,160,0.4453125,0.333333333333333,0.608163265306122,0.111979166666667
"Chr08","894777","T","C",82,39,121,160,98,94,192,160,0.489583333333333,0.322314049586777,0.575079872204473,0.167269283746556
"Chr08","894799","T","G",81,42,123,138,90,98,188,138,0.521276595744681,0.341463414634146,0.54983922829582,0.179813181110535
"Chr08","894842","G","A",68,42,110,136,93,106,199,136,0.532663316582915,0.381818181818182,0.521035598705502,0.150845134764733
"Chr08","894854","A","G",58,35,93,137,93,91,184,137,0.494565217391304,0.376344086021505,0.545126353790614,0.118221131369799
"Chr08","894875","C","T",83,34,117,160,122,84,206,160,0.407766990291262,0.290598290598291,0.634674922600619,0.117168699692972
"Chr08","894901","G","A",90,39,129,160,116,82,198,160,0.414141414141414,0.302325581395349,0.629969418960245,0.111815832746065
"Chr08","895043","G","A",98,71,169,138,90,97,187,138,0.518716577540107,0.420118343195266,0.528089887640449,0.0985982343448407
"Chr08","895050","A","T",98,74,172,160,85,98,183,160,0.53551912568306,0.430232558139535,0.515492957746479,0.105286567543525
"Chr08","895071","A","G",95,75,170,160,85,86,171,160,0.502923976608187,0.441176470588235,0.527859237536657,0.0617475060199518
"Chr08","895231","A","C",69,30,99,160,108,73,181,160,0.403314917127072,0.303030303030303,0.632142857142857,0.100284614096769
"Chr08","895964","A","G",79,76,155,137,89,107,196,137,0.545918367346939,0.490322580645161,0.478632478632479,0.0555957867017775
"Chr08","895971","C","T",80,70,150,160,90,108,198,160,0.545454545454545,0.466666666666667,0.488505747126437,0.0787878787878787
"Chr08","896033","G","A",82,72,154,160,108,125,233,160,0.536480686695279,0.467532467532468,0.490956072351421,0.0689482191628114
"Chr08","896042","C","T",83,68,151,140,111,121,232,140,0.521551724137931,0.450331125827815,0.506527415143603,0.0712205983101165
"Chr08","896088","T","A",130,68,198,136,129,129,258,136,0.5,0.343434343434343,0.567982456140351,0.156565656565657
"Chr08","896093","G","A",126,68,194,160,124,123,247,160,0.497975708502024,0.350515463917526,0.566893424036281,0.147460244584499
"Chr08","896166","A","G",115,59,174,160,102,87,189,160,0.46031746031746,0.339080459770115,0.597796143250689,0.121237000547345
"Chr08","896176","T","G",119,59,178,160,106,89,195,160,0.456410256410256,0.331460674157303,0.603217158176944,0.124949582252953
"Chr08","896277","G","A",108,55,163,160,121,87,208,160,0.418269230769231,0.337423312883436,0.617250673854447,0.0808459178857952
"Chr08","896356","C","T",60,73,133,160,80,85,165,160,0.515151515151515,0.548872180451128,0.469798657718121,-0.0337206652996127
"Chr08","896408","A","G",73,86,159,160,84,87,171,160,0.508771929824561,0.540880503144654,0.475757575757576,-0.0321085733200926
"Chr08","896505","C","T",95,75,170,160,83,77,160,160,0.48125,0.441176470588235,0.539393939393939,0.0400735294117647
"Chr08","896929","T","C",79,66,145,142,76,73,149,142,0.48993288590604,0.455172413793103,0.527210884353742,0.0347604721129368
"Chr08","896957","G","A",101,68,169,160,87,86,173,160,0.497109826589595,0.402366863905325,0.549707602339181,0.0947429626842699
"Chr08","897039","G","C",79,75,154,160,94,90,184,160,0.489130434782609,0.487012987012987,0.511834319526627,0.00211744776962169
"Chr08","897044","G","C",79,72,151,158,93,89,182,158,0.489010989010989,0.47682119205298,0.516516516516517,0.0121897969580089
"Chr08","897064","T","G",85,73,158,139,107,92,199,139,0.462311557788945,0.462025316455696,0.53781512605042,0.000286241333248505
"Chr08","897247","G","T",93,76,169,160,125,115,240,160,0.479166666666667,0.449704142011834,0.533007334963325,0.0294625246548323
"Chr08","897257","C","T",87,75,162,140,120,112,232,140,0.482758620689655,0.462962962962963,0.525380710659898,0.0197956577266922
"Chr08","897348","C","T",100,71,171,160,104,94,198,160,0.474747474747475,0.415204678362573,0.552845528455285,0.0595427963849017
"Chr08","897364","G","A",111,64,175,145,101,100,201,145,0.497512437810945,0.365714285714286,0.563829787234043,0.13179815209666
"Chr08","897370","A","C",116,63,179,160,117,90,207,160,0.434782608695652,0.35195530726257,0.603626943005181,0.0828273014330823
"Chr08","897393","C","T",115,70,185,160,116,97,213,160,0.455399061032864,0.378378378378378,0.580402010050251,0.0770206826544855
"Chr08","897516","T","C",120,80,200,160,156,107,263,160,0.406844106463878,0.4,0.596112311015119,0.00684410646387829
"Chr08","898131","C","T",66,70,136,160,76,99,175,160,0.565714285714286,0.514705882352941,0.456591639871383,0.0510084033613446
"Chr08","898354","G","A",84,78,162,160,72,108,180,160,0.6,0.481481481481481,0.456140350877193,0.118518518518519
"Chr08","898410","G","A",91,68,159,160,72,106,178,160,0.595505617977528,0.427672955974843,0.483679525222552,0.167832662002685
"Chr08","898772","A","G",85,54,139,160,65,61,126,160,0.484126984126984,0.388489208633094,0.566037735849057,0.0956377754938906
"Chr08","898862","G","A",99,51,150,143,55,72,127,143,0.566929133858268,0.34,0.555956678700361,0.226929133858268
"Chr08","898932","T","A",89,36,125,160,56,81,137,160,0.591240875912409,0.288,0.553435114503817,0.303240875912409
"Chr08","898959","G","A",83,36,119,160,72,79,151,160,0.52317880794702,0.302521008403361,0.574074074074074,0.220657799543659
"Chr08","898997","A","C",64,37,101,160,69,77,146,160,0.527397260273973,0.366336633663366,0.538461538461538,0.161060626610606
"Chr08","899060","T","A",66,36,102,140,77,77,154,140,0.5,0.352941176470588,0.55859375,0.147058823529412
"Chr08","899066","A","G",68,38,106,140,80,79,159,140,0.49685534591195,0.358490566037736,0.558490566037736,0.138364779874214
"Chr08","899168","A","G",85,63,148,139,87,97,184,139,0.527173913043478,0.425675675675676,0.518072289156627,0.101498237367803
"Chr08","899260","T","C",79,49,128,160,72,69,141,160,0.48936170212766,0.3828125,0.561338289962825,0.10654920212766
"Chr08","899429","A","G",96,66,162,136,74,103,177,136,0.581920903954802,0.407407407407407,0.501474926253687,0.174513496547395
"Chr08","899528","A","G",75,39,114,141,82,76,158,141,0.481012658227848,0.342105263157895,0.577205882352941,0.138907395069953
"Chr08","899581","G","A",62,34,96,160,90,76,166,160,0.457831325301205,0.354166666666667,0.580152671755725,0.103664658634538
"Chr08","899601","A","G",60,33,93,139,91,78,169,139,0.461538461538462,0.354838709677419,0.576335877862595,0.106699751861042
"Chr08","899619","G","A",50,31,81,160,73,55,128,160,0.4296875,0.382716049382716,0.588516746411483,0.046971450617284
"Chr08","899758","G","T",64,122,186,160,101,95,196,160,0.48469387755102,0.655913978494624,0.431937172774869,-0.171220100943603
"Chr08","899762","T","G",122,64,186,160,94,101,195,160,0.517948717948718,0.344086021505376,0.566929133858268,0.173862696443342
"Chr08","899769","T","C",122,64,186,143,96,109,205,143,0.531707317073171,0.344086021505376,0.557544757033248,0.187621295567794
"Chr08","899794","A","G",118,68,186,142,103,126,229,142,0.550218340611354,0.365591397849462,0.532530120481928,0.184626942761891
"Chr08","899819","A","G",96,66,162,160,94,108,202,160,0.534653465346535,0.407407407407407,0.521978021978022,0.127246057939127
"Chr08","900010","C","G",100,47,147,160,81,90,171,160,0.526315789473684,0.319727891156463,0.569182389937107,0.206587898317222
"Chr08","900023","G","T",96,47,143,160,80,91,171,160,0.532163742690059,0.328671328671329,0.560509554140127,0.20349241401873
"Chr08","900142","C","A",91,52,143,160,112,73,185,160,0.394594594594595,0.363636363636364,0.61890243902439,0.030958230958231
"Chr08","900287","A","G",88,60,148,160,117,81,198,160,0.409090909090909,0.405405405405405,0.592485549132948,0.00368550368550369
"Chr08","900314","G","A",95,66,161,160,120,102,222,160,0.459459459459459,0.409937888198758,0.561357702349869,0.0495215712607017
"Chr08","900319","C","G",99,64,163,140,119,100,219,140,0.45662100456621,0.392638036809816,0.570680628272251,0.0639829677563941
"Chr08","900337","C","G",111,62,173,160,119,105,224,160,0.46875,0.358381502890173,0.579345088161209,0.110368497109827
"Chr08","900486","C","A",66,55,121,140,76,76,152,140,0.5,0.454545454545455,0.52014652014652,0.0454545454545455
"Chr08","900589","G","A",58,72,130,160,63,82,145,160,0.56551724137931,0.553846153846154,0.44,0.0116710875331565
"Chr08","900663","C","T",80,52,132,154,71,68,139,154,0.489208633093525,0.393939393939394,0.55719557195572,0.0952692391541313
"Chr08","900670","G","C",79,51,130,160,69,70,139,160,0.503597122302158,0.392307692307692,0.550185873605948,0.111289429994466
"Chr08","900717","T","G",89,53,142,160,82,80,162,160,0.493827160493827,0.373239436619718,0.5625,0.120587723874109
"Chr08","900755","A","C",90,54,144,160,89,92,181,160,0.50828729281768,0.375,0.550769230769231,0.13328729281768
"Chr08","900796","A","G",98,47,145,160,112,83,195,160,0.425641025641026,0.324137931034483,0.617647058823529,0.101503094606543
"Chr08","900845","C","A",108,59,167,138,122,98,220,138,0.445454545454545,0.353293413173653,0.594315245478036,0.0921611322808927
"Chr08","900864","G","C",117,57,174,160,124,110,234,160,0.47008547008547,0.327586206896552,0.590686274509804,0.142499263188918
"Chr08","900882","A","C",117,59,176,144,122,109,231,144,0.471861471861472,0.335227272727273,0.587223587223587,0.136634199134199
"Chr08","900894","G","T",115,54,169,136,122,105,227,136,0.462555066079295,0.319526627218935,0.598484848484849,0.14302843886036
"Chr08","900899","G","A",119,54,173,136,122,106,228,136,0.464912280701754,0.312138728323699,0.600997506234414,0.152773552378055
"Chr08","900924","G","T",110,51,161,138,101,92,193,138,0.476683937823834,0.316770186335404,0.596045197740113,0.15991375148843
"Chr08","900974","T","C",92,60,152,138,83,82,165,138,0.496969696969697,0.394736842105263,0.55205047318612,0.102232854864434
"Chr08","900986","A","G",85,54,139,140,86,76,162,140,0.469135802469136,0.388489208633094,0.568106312292359,0.0806465938360422
"Chr08","901040","T","C",74,52,126,160,89,61,150,160,0.406666666666667,0.412698412698413,0.590579710144927,-0.006031746031746
"Chr08","901097","A","C",69,61,130,160,84,79,163,160,0.484662576687117,0.469230769230769,0.522184300341297,0.0154318074563473
"Chr08","901208","T","G",61,81,142,160,86,93,179,160,0.519553072625698,0.570422535211268,0.457943925233645,-0.0508694625855693
"Chr08","901326","T","C",55,71,126,160,65,78,143,160,0.545454545454545,0.563492063492063,0.446096654275093,-0.0180375180375181
"Chr08","901450","A","G",66,126,192,160,95,104,199,160,0.522613065326633,0.65625,0.411764705882353,-0.133636934673367
"Chr08","901481","A","C",75,116,191,160,103,78,181,160,0.430939226519337,0.607329842931937,0.478494623655914,-0.1763906164126
"Chr08","901492","T","C",113,80,193,141,77,100,177,141,0.564971751412429,0.414507772020725,0.513513513513513,0.150463979391704
"Chr08","901549","C","T",66,87,153,149,90,65,155,149,0.419354838709677,0.568627450980392,0.506493506493506,-0.149272612270715
"Chr08","901702","G","A",30,68,98,145,41,46,87,145,0.528735632183908,0.693877551020408,0.383783783783784,-0.1651419188365
"Chr08","901714","C","A",76,27,103,142,51,47,98,142,0.479591836734694,0.262135922330097,0.631840796019901,0.217455914404597
"Chr08","901814","A","G",65,40,105,137,44,54,98,137,0.551020408163265,0.380952380952381,0.536945812807882,0.170068027210884
"Chr08","901996","C","A",34,27,61,141,26,37,63,141,0.587301587301587,0.442622950819672,0.483870967741935,0.144678636481915
"Chr08","902863","G","A",44,29,73,160,25,48,73,160,0.657534246575342,0.397260273972603,0.472602739726027,0.26027397260274
"Chr08","906662","G","C",88,43,131,139,88,97,185,139,0.524324324324324,0.32824427480916,0.556962025316456,0.196080049515164
"Chr08","906769","C","A",57,34,91,140,41,76,117,140,0.64957264957265,0.373626373626374,0.471153846153846,0.275946275946276
"Chr08","906805","T","A",43,41,84,152,30,76,106,152,0.716981132075472,0.488095238095238,0.384210526315789,0.228885893980234
"Chr08","906827","T","C",48,31,79,160,28,62,90,160,0.688888888888889,0.392405063291139,0.449704142011834,0.29648382559775
"Chr08","906869","G","C",45,35,80,139,24,59,83,139,0.710843373493976,0.4375,0.423312883435583,0.273343373493976
"Chr08","906924","G","A",39,30,69,142,41,47,88,142,0.534090909090909,0.434782608695652,0.509554140127389,0.0993083003952569
"Chr08","906950","C","T",34,28,62,139,42,35,77,139,0.454545454545455,0.451612903225806,0.546762589928058,0.00293255131964809
"Chr08","907011","C","T",31,29,60,142,41,38,79,142,0.481012658227848,0.483333333333333,0.517985611510791,-0.00232067510548523
"Chr08","907082","C","A",29,24,53,160,22,38,60,160,0.633333333333333,0.452830188679245,0.451327433628319,0.180503144654088
"Chr08","939164","G","A",90,40,130,139,94,80,174,139,0.459770114942529,0.307692307692308,0.605263157894737,0.152077807250221
"Chr08","956220","C","T",76,49,125,141,58,66,124,141,0.532258064516129,0.392,0.538152610441767,0.140258064516129
"Chr08","957394","G","T",78,50,128,160,93,87,180,160,0.483333333333333,0.390625,0.555194805194805,0.0927083333333333
"Chr08","958803","C","T",55,28,83,140,56,51,107,140,0.476635514018692,0.337349397590361,0.58421052631579,0.13928611642833
"Chr08","962409","C","T",35,31,66,160,44,39,83,160,0.469879518072289,0.46969696969697,0.530201342281879,0.000182548375319447
"Chr08","963947","G","A",72,38,110,160,73,54,127,160,0.425196850393701,0.345454545454545,0.611814345991561,0.0797423049391554
"Chr08","966634","C","T",74,46,120,148,68,72,140,148,0.514285714285714,0.383333333333333,0.546153846153846,0.130952380952381
"Chr08","991661","C","T",48,29,77,141,56,36,92,141,0.391304347826087,0.376623376623377,0.615384615384615,0.0146809712027103
"Chr08","999237","T","C",37,59,96,160,60,69,129,160,0.534883720930233,0.614583333333333,0.431111111111111,-0.0796996124031009
"Chr08","1001371","C","T",54,53,107,160,52,72,124,160,0.580645161290323,0.495327102803738,0.458874458874459,0.0853180584865843
"Chr08","1002895","G","A",34,60,94,160,43,50,93,160,0.537634408602151,0.638297872340426,0.411764705882353,-0.100663463738275
"Chr08","1003288","C","A",74,104,178,144,72,68,140,144,0.485714285714286,0.584269662921348,0.459119496855346,-0.0985553772070626
"Chr08","1011569","T","C",45,30,75,160,39,34,73,160,0.465753424657534,0.4,0.567567567567568,0.0657534246575342
"Chr08","1015530","C","T",62,34,96,141,74,81,155,141,0.52258064516129,0.354166666666667,0.541832669322709,0.168413978494624
"Chr08","1020027","G","A",28,25,53,140,44,27,71,140,0.380281690140845,0.471698113207547,0.580645161290323,-0.0914164230667021
"Chr08","1048134","A","C",76,45,121,136,73,65,138,136,0.471014492753623,0.371900826446281,0.575289575289575,0.0991136663073422
"Chr08","1065002","A","T",38,39,77,150,49,59,108,150,0.546296296296296,0.506493506493506,0.47027027027027,0.0398027898027898
"Chr08","1067034","A","G",81,125,206,160,116,116,232,160,0.5,0.606796116504854,0.449771689497717,-0.106796116504854
"Chr08","1071445","T","C",29,18,47,142,40,36,76,142,0.473684210526316,0.382978723404255,0.560975609756098,0.0907054871220604
"Chr08","1073273","C","T",35,69,104,160,73,68,141,160,0.482269503546099,0.663461538461538,0.440816326530612,-0.181192034915439
"Chr08","1073322","C","G",59,35,94,141,67,79,146,141,0.541095890410959,0.372340425531915,0.525,0.168755464879044
"Chr08","1073347","T","C",77,37,114,137,93,107,200,137,0.535,0.324561403508772,0.54140127388535,0.210438596491228
"Chr08","1073676","C","G",98,55,153,160,89,90,179,160,0.502793296089385,0.359477124183007,0.563253012048193,0.143316171906379
"Chr08","1074519","T","C",56,39,95,160,54,65,119,160,0.546218487394958,0.410526315789474,0.514018691588785,0.135692171605484
"Chr08","1074589","A","G",72,35,107,142,72,77,149,142,0.516778523489933,0.327102803738318,0.5625,0.189675719751615
"Chr08","1074613","A","G",37,76,113,160,71,70,141,160,0.49645390070922,0.672566371681416,0.425196850393701,-0.176112470972196
"Chr08","1085095","T","C",101,42,143,160,92,56,148,160,0.378378378378378,0.293706293706294,0.663230240549828,0.0846720846720847
"Chr08","1085396","T","G",59,36,95,141,76,56,132,141,0.424242424242424,0.378947368421053,0.594713656387665,0.0452950558213716
"Chr08","1085404","T","C",60,34,94,160,74,56,130,160,0.430769230769231,0.361702127659574,0.598214285714286,0.0690671031096563
"Chr08","1088155","T","C",50,76,126,160,72,66,138,160,0.478260869565217,0.603174603174603,0.462121212121212,-0.124913733609386
"Chr08","1088895","G","A",60,44,104,160,59,52,111,160,0.468468468468468,0.423076923076923,0.553488372093023,0.0453915453915454
"Chr08","1089080","C","G",41,31,72,160,50,34,84,160,0.404761904761905,0.430555555555556,0.583333333333333,-0.0257936507936508
"Chr08","1089294","T","G",20,19,39,160,29,14,43,160,0.325581395348837,0.487179487179487,0.597560975609756,-0.16159809183065
"Chr08","1089814","A","C",0,4,4,17,10,8,18,160,0.444444444444444,1,0.454545454545455,-0.555555555555556
"Chr08","1089978","T","G",7,4,11,85,6,2,8,40,0.25,0.363636363636364,0.684210526315789,-0.113636363636364
"Chr08","1097737","G","A",29,18,47,142,28,42,70,142,0.6,0.382978723404255,0.487179487179487,0.217021276595745
"Chr08","1097847","G","A",39,23,62,160,40,32,72,160,0.444444444444444,0.370967741935484,0.58955223880597,0.0734767025089605
"Chr08","1097848","G","A",24,39,63,160,33,40,73,160,0.547945205479452,0.619047619047619,0.419117647058824,-0.071102413568167
"Chr08","1097863","C","T",44,30,74,140,44,39,83,140,0.469879518072289,0.405405405405405,0.560509554140127,0.0644741126668837
"Chr08","1097880","G","C",44,31,75,160,42,39,81,160,0.481481481481481,0.413333333333333,0.551282051282051,0.0681481481481481
"Chr08","1098025","A","G",27,54,81,160,24,40,64,160,0.625,0.666666666666667,0.351724137931034,-0.0416666666666666
"Chr08","1098052","G","A",37,23,60,160,32,27,59,160,0.457627118644068,0.383333333333333,0.579831932773109,0.0742937853107344
"Chr08","1098121","C","A",15,18,33,160,21,19,40,160,0.475,0.545454545454545,0.493150684931507,-0.0704545454545454
"Chr08","1099294","C","T",33,65,98,140,55,58,113,140,0.513274336283186,0.663265306122449,0.417061611374408,-0.149990969839263
"Chr08","1099696","C","T",37,60,97,160,69,56,125,160,0.448,0.618556701030928,0.477477477477477,-0.170556701030928
"Chr08","1100908","C","T",33,64,97,148,53,59,112,148,0.526785714285714,0.65979381443299,0.411483253588517,-0.133008100147275
"Chr08","1101123","T","A",25,53,78,145,46,54,100,145,0.54,0.67948717948718,0.398876404494382,-0.139487179487179
"Chr08","1102559","T","C",4,8,12,99,13,6,19,130,0.315789473684211,0.666666666666667,0.548387096774194,-0.350877192982456
"Chr08","1103678","A","T",42,67,109,142,76,64,140,142,0.457142857142857,0.614678899082569,0.473895582329317,-0.157536041939712
"Chr08","1104365","C","G",59,84,143,160,94,73,167,160,0.437125748502994,0.587412587412587,0.493548387096774,-0.150286838909593
"Chr08","1106969","C","T",82,54,136,140,86,58,144,140,0.402777777777778,0.397058823529412,0.6,0.00571895424836605
"Chr08","1109679","C","A",29,62,91,153,58,69,127,153,0.543307086614173,0.681318681318681,0.399082568807339,-0.138011594704508
"Chr08","1111185","C","T",27,27,54,160,29,35,64,160,0.546875,0.5,0.474576271186441,0.046875
"Chr08","1111238","C","T",30,34,64,160,40,48,88,160,0.545454545454545,0.53125,0.460526315789474,0.0142045454545454
"Chr08","1111244","T","G",30,34,64,160,40,47,87,160,0.540229885057471,0.53125,0.463576158940397,0.00897988505747127
"Chr08","1111305","A","G",18,23,41,160,25,35,60,160,0.583333333333333,0.560975609756098,0.425742574257426,0.0223577235772358
"Chr08","1111525","A","G",19,33,52,142,31,29,60,142,0.483333333333333,0.634615384615385,0.446428571428571,-0.151282051282051
"Chr08","1111588","T","C",18,37,55,160,32,30,62,160,0.483870967741935,0.672727272727273,0.427350427350427,-0.188856304985337
"Chr08","1112596","T","C",16,26,42,143,32,42,74,143,0.567567567567568,0.619047619047619,0.413793103448276,-0.0514800514800515
"Chr08","1114174","A","T",36,36,72,160,39,47,86,160,0.546511627906977,0.5,0.474683544303797,0.0465116279069767
"Chr08","1114330","C","T",28,63,91,160,47,60,107,160,0.560747663551402,0.692307692307692,0.378787878787879,-0.13156002875629
"Chr08","1115575","G","A",54,78,132,136,85,108,193,136,0.559585492227979,0.590909090909091,0.427692307692308,-0.0313235986811117
"Chr08","1116241","G","T",30,65,95,143,43,51,94,143,0.542553191489362,0.684210526315789,0.386243386243386,-0.141657334826428
"Chr08","1116307","C","T",36,47,83,160,49,48,97,160,0.494845360824742,0.566265060240964,0.472222222222222,-0.0714196994162216
"Chr08","1117073","G","A",24,46,70,160,43,34,77,160,0.441558441558442,0.657142857142857,0.45578231292517,-0.215584415584416
"Chr08","1117103","G","A",26,43,69,160,48,38,86,160,0.441860465116279,0.623188405797101,0.47741935483871,-0.181327940680822
"Chr08","1117181","T","C",40,55,95,160,60,59,119,160,0.495798319327731,0.578947368421053,0.467289719626168,-0.0831490490933215
"Chr08","1117208","A","G",44,55,99,140,60,60,120,140,0.5,0.555555555555556,0.474885844748858,-0.0555555555555556
"Chr08","1117406","C","G",51,84,135,138,77,93,170,138,0.547058823529412,0.622222222222222,0.419672131147541,-0.0751633986928104
"Chr08","1117807","C","A",65,62,127,160,76,83,159,160,0.522012578616352,0.488188976377953,0.493006993006993,0.0338236022383994
"Chr08","1117869","T","G",60,68,128,151,65,69,134,151,0.514925373134328,0.53125,0.477099236641221,-0.0163246268656716
"Chr08","1117901","A","G",55,69,124,160,58,71,129,160,0.550387596899225,0.556451612903226,0.446640316205534,-0.00606401600400097
"Chr08","1117977","T","G",54,61,115,146,62,52,114,146,0.456140350877193,0.530434782608696,0.506550218340611,-0.0742944317315027
"Chr08","1117998","A","G",49,53,102,160,66,49,115,160,0.426086956521739,0.519607843137255,0.529953917050691,-0.0935208866155158
"Chr08","1118176","T","G",72,66,138,160,88,65,153,160,0.42483660130719,0.478260869565217,0.549828178694158,-0.0534242682580279
"Chr08","1118360","T","C",51,54,105,147,80,71,151,147,0.470198675496689,0.514285714285714,0.51171875,-0.0440870387890255
"Chr08","1118378","A","G",52,55,107,141,72,68,140,141,0.485714285714286,0.514018691588785,0.502024291497976,-0.0283044058744993
"Chr08","1118479","T","A",39,52,91,160,65,54,119,160,0.453781512605042,0.571428571428571,0.495238095238095,-0.117647058823529
"Chr08","1118829","C","T",48,80,128,160,95,88,183,160,0.480874316939891,0.625,0.459807073954984,-0.144125683060109
"Chr08","1118848","A","G",51,81,132,160,93,83,176,160,0.471590909090909,0.613636363636364,0.467532467532468,-0.142045454545455
"Chr08","1119513","C","A",45,76,121,139,68,88,156,139,0.564102564102564,0.628099173553719,0.407942238267148,-0.0639966094511549
"Chr08","1119549","C","T",58,96,154,137,96,124,220,137,0.563636363636364,0.623376623376623,0.411764705882353,-0.0597402597402598
"Chr08","1119572","T","C",62,95,157,160,94,123,217,160,0.566820276497696,0.605095541401274,0.417112299465241,-0.038275264903578
"Chr08","1119579","A","C",62,93,155,136,92,122,214,136,0.570093457943925,0.6,0.417344173441734,-0.0299065420560748
"Chr08","1119596","C","T",64,100,164,160,93,122,215,160,0.567441860465116,0.609756097560976,0.414248021108179,-0.0423142370958594
"Chr08","1119681","G","A",65,102,167,160,99,102,201,160,0.507462686567164,0.610778443113772,0.445652173913043,-0.103315756546608
"Chr08","1119801","A","G",56,91,147,138,107,85,192,138,0.442708333333333,0.619047619047619,0.480825958702065,-0.176339285714286
"Chr08","1119896","C","A",47,68,115,142,77,79,156,142,0.506410256410256,0.591304347826087,0.457564575645756,-0.0848940914158306
"Chr08","1120008","T","A",65,108,173,160,91,102,193,160,0.528497409326425,0.624277456647399,0.426229508196721,-0.095780047320974
"Chr08","1120025","A","G",70,119,189,160,91,98,189,160,0.518518518518518,0.62962962962963,0.425925925925926,-0.111111111111111
"Chr08","1120102","T","C",65,127,192,160,91,113,204,160,0.553921568627451,0.661458333333333,0.393939393939394,-0.107536764705882
"Chr08","1120193","A","G",64,105,169,160,93,117,210,160,0.557142857142857,0.621301775147929,0.414248021108179,-0.0641589180050718
"Chr08","1120220","C","A",60,105,165,139,90,116,206,139,0.563106796116505,0.636363636363636,0.404312668463612,-0.0732568402471315
"Chr08","1120708","G","A",45,98,143,137,90,92,182,137,0.505494505494505,0.685314685314685,0.415384615384615,-0.17982017982018
"Chr08","1120828","A","G",59,98,157,160,77,78,155,160,0.503225806451613,0.624203821656051,0.435897435897436,-0.120978015204438
"Chr08","1120833","T","A",58,101,159,138,74,86,160,138,0.5375,0.635220125786163,0.413793103448276,-0.0977201257861635
"Chr08","1120919","A","G",49,86,135,144,67,92,159,144,0.578616352201258,0.637037037037037,0.394557823129252,-0.0584206848357792
"Chr08","1121580","G","A",39,76,115,160,45,67,112,160,0.598214285714286,0.660869565217391,0.370044052863436,-0.0626552795031056
"Chr08","1121659","C","G",40,96,136,160,55,86,141,160,0.609929078014184,0.705882352941177,0.342960288808664,-0.0959532749269921
"Chr08","1121788","T","A",75,101,176,137,111,99,210,137,0.471428571428571,0.573863636363636,0.481865284974093,-0.102435064935065
"Chr08","1121836","A","G",71,105,176,160,92,78,170,160,0.458823529411765,0.596590909090909,0.471098265895954,-0.137767379679144
"Chr08","1121878","A","C",83,106,189,160,95,107,202,160,0.52970297029703,0.560846560846561,0.455242966751918,-0.0311435905495311
"Chr08","1121924","C","A",78,101,179,160,99,116,215,160,0.53953488372093,0.564245810055866,0.449238578680203,-0.0247109263349357
"Chr08","1122124","C","T",72,84,156,160,92,69,161,160,0.428571428571429,0.538461538461538,0.517350157728707,-0.10989010989011
"Chr08","1122204","T","G",59,115,174,140,84,83,167,140,0.497005988023952,0.660919540229885,0.419354838709677,-0.163913552205933
"Chr08","1122839","G","T",42,36,78,147,35,57,92,147,0.619565217391304,0.461538461538462,0.452941176470588,0.158026755852843
"Chr08","1123129","T","G",10,14,24,160,11,21,32,160,0.65625,0.583333333333333,0.375,0.0729166666666666
"Chr08","1123819","A","G",6,13,19,135,14,8,22,160,0.363636363636364,0.684210526315789,0.48780487804878,-0.320574162679426
"Chr08","1123835","C","G",5,11,16,100,19,11,30,160,0.366666666666667,0.6875,0.521739130434783,-0.320833333333333
"Chr08","1123866","T","A",22,50,72,160,50,46,96,160,0.479166666666667,0.694444444444444,0.428571428571429,-0.215277777777778
"Chr08","1123891","A","G",30,47,77,136,58,41,99,136,0.414141414141414,0.61038961038961,0.5,-0.196248196248196
"Chr08","1123896","T","G",30,47,77,137,59,41,100,137,0.41,0.61038961038961,0.502824858757062,-0.20038961038961
"Chr08","1123928","T","C",31,69,100,160,66,61,127,160,0.480314960629921,0.69,0.427312775330396,-0.209685039370079
"Chr08","1123949","A","G",31,71,102,160,65,56,121,160,0.462809917355372,0.696078431372549,0.430493273542601,-0.233268514017177
"Chr08","1124098","A","G",44,65,109,160,71,69,140,160,0.492857142857143,0.596330275229358,0.461847389558233,-0.103473132372215
"Chr08","1124173","C","T",45,65,110,145,77,62,139,145,0.446043165467626,0.590909090909091,0.48995983935743,-0.144865925441465
"Chr08","1124221","T","C",23,60,83,148,51,51,102,148,0.5,0.72289156626506,0.4,-0.22289156626506
"Chr08","1124357","C","T",47,66,113,136,90,67,157,136,0.426751592356688,0.584070796460177,0.507407407407407,-0.157319204103489
"Chr08","1124387","T","C",48,58,106,142,83,68,151,142,0.450331125827815,0.547169811320755,0.509727626459144,-0.0968386854929401
"Chr08","1124447","T","A",57,77,134,160,91,78,169,160,0.461538461538462,0.574626865671642,0.488448844884488,-0.11308840413318
"Chr08","1124476","G","A",57,79,136,137,99,80,179,137,0.446927374301676,0.580882352941177,0.495238095238095,-0.133954978639501
"Chr08","1124492","A","G",54,80,134,160,101,76,177,160,0.429378531073446,0.597014925373134,0.498392282958199,-0.167636394299688
"Chr08","1124630","A","G",43,97,140,160,84,88,172,160,0.511627906976744,0.692857142857143,0.407051282051282,-0.181229235880399
"Chr08","1124710","C","T",49,76,125,160,62,72,134,160,0.537313432835821,0.608,0.428571428571429,-0.0706865671641791
"Chr08","1124888","C","T",46,58,104,143,53,92,145,143,0.63448275862069,0.557692307692308,0.397590361445783,0.076790450928382
"Chr08","1124943","A","G",50,78,128,139,67,90,157,139,0.573248407643312,0.609375,0.410526315789474,-0.0361265923566879
"Chr08","1125117","A","G",59,93,152,140,76,79,155,140,0.509677419354839,0.611842105263158,0.439739413680782,-0.102164685908319
"Chr08","1125128","C","T",57,83,140,139,71,78,149,139,0.523489932885906,0.592857142857143,0.442906574394464,-0.0693672099712368
"Chr08","1125810","G","A",20,31,51,160,32,24,56,160,0.428571428571429,0.607843137254902,0.485981308411215,-0.179271708683473
"Chr08","1125836","C","T",18,30,48,145,30,21,51,145,0.411764705882353,0.625,0.484848484848485,-0.213235294117647
"Chr08","1127674","T","G",44,66,110,160,52,59,111,160,0.531531531531532,0.6,0.434389140271493,-0.0684684684684684
"Chr08","1127834","A","G",41,60,101,138,49,71,120,138,0.591666666666667,0.594059405940594,0.407239819004525,-0.00239273927392736
"Chr08","1127966","T","C",34,52,86,147,47,53,100,147,0.53,0.604651162790698,0.435483870967742,-0.0746511627906976
"Chr08","1127994","T","C",32,51,83,160,51,50,101,160,0.495049504950495,0.614457831325301,0.451086956521739,-0.119408326374806
"Chr08","1128011","G","T",35,52,87,141,49,47,96,141,0.489583333333333,0.597701149425287,0.459016393442623,-0.108117816091954
"Chr08","1128033","A","G",32,48,80,160,51,40,91,160,0.43956043956044,0.6,0.485380116959064,-0.16043956043956
"Chr08","1128257","T","C",17,24,41,160,36,31,67,160,0.462686567164179,0.585365853658537,0.490740740740741,-0.122679286494357
"Chr08","1128605","A","C",17,14,31,147,15,20,35,147,0.571428571428571,0.451612903225806,0.484848484848485,0.119815668202765
"Chr08","1128846","C","T",28,40,68,143,57,43,100,143,0.43,0.588235294117647,0.505952380952381,-0.158235294117647
"Chr08","1128997","G","A",18,26,44,142,28,35,63,142,0.555555555555556,0.590909090909091,0.429906542056075,-0.0353535353535354
"Chr08","1129377","T","C",16,34,50,160,29,38,67,160,0.567164179104478,0.68,0.384615384615385,-0.112835820895522
"Chr08","1129398","G","T",17,35,52,160,28,32,60,160,0.533333333333333,0.673076923076923,0.401785714285714,-0.13974358974359
"Chr08","1129454","G","A",12,31,43,160,25,26,51,160,0.509803921568627,0.720930232558139,0.393617021276596,-0.211126310989512
"Chr08","1129723","A","G",22,50,72,140,63,55,118,140,0.466101694915254,0.694444444444444,0.447368421052632,-0.22834274952919
"Chr08","1129876","T","C",23,48,71,139,40,36,76,139,0.473684210526316,0.676056338028169,0.428571428571429,-0.202372127501853
"Chr08","1130069","T","A",41,84,125,142,94,68,162,142,0.419753086419753,0.672,0.470383275261324,-0.252246913580247
"Chr08","1130899","A","G",74,89,163,160,104,95,199,160,0.477386934673367,0.54601226993865,0.49171270718232,-0.0686253352652834
"Chr08","1131048","G","A",37,59,96,160,61,78,139,160,0.561151079136691,0.614583333333333,0.417021276595745,-0.0534322541966428
"Chr08","1132144","T","G",35,64,99,140,54,49,103,140,0.475728155339806,0.646464646464647,0.440594059405941,-0.170736491124841
"Chr08","1132283","C","T",41,36,77,151,55,43,98,151,0.438775510204082,0.467532467532468,0.548571428571429,-0.0287569573283859
"Chr08","1132360","A","G",26,43,69,160,52,42,94,160,0.446808510638298,0.623188405797101,0.478527607361963,-0.176379895158804
"Chr08","1132534","A","G",24,35,59,160,53,27,80,160,0.3375,0.593220338983051,0.553956834532374,-0.255720338983051
"Chr08","1132601","T","C",30,46,76,160,57,44,101,160,0.435643564356436,0.605263157894737,0.491525423728814,-0.169619593538301
"Chr08","1132748","A","G",39,48,87,141,72,55,127,141,0.433070866141732,0.551724137931034,0.518691588785047,-0.118653271789302
"Chr08","1132824","A","C",54,73,127,160,82,72,154,160,0.467532467532468,0.574803149606299,0.483985765124555,-0.107270682073832
"Chr08","1133762","G","A",63,101,164,160,118,111,229,160,0.48471615720524,0.615853658536585,0.460559796437659,-0.131137501331345
"Chr08","1133791","G","C",75,118,193,160,110,123,233,160,0.527896995708155,0.61139896373057,0.434272300469484,-0.0835019680224154
"Chr08","1133945","A","T",43,64,107,147,52,78,130,147,0.6,0.598130841121495,0.40084388185654,0.0018691588785047
"Chr08","1134416","T","C",31,60,91,160,46,60,106,160,0.566037735849057,0.659340659340659,0.390862944162437,-0.0933029234916027
"Chr08","1135883","A","T",78,126,204,160,133,105,238,160,0.441176470588235,0.617647058823529,0.47737556561086,-0.176470588235294
"Chr08","1136985","T","C",50,71,121,160,100,90,190,160,0.473684210526316,0.586776859504132,0.482315112540193,-0.113092648977817
"Chr08","1138527","T","C",29,55,84,150,44,78,122,150,0.639344262295082,0.654761904761905,0.354368932038835,-0.0154176424668228
"Chr08","1138669","A","T",51,87,138,160,82,115,197,160,0.583756345177665,0.630434782608696,0.397014925373134,-0.0466784374310307
"Chr08","1138912","T","A",29,34,63,144,44,51,95,144,0.536842105263158,0.53968253968254,0.462025316455696,-0.00284043441938175
"Chr08","1140281","C","T",33,29,62,143,30,28,58,143,0.482758620689655,0.467741935483871,0.525,0.0150166852057843
"Chr08","1143075","C","T",23,49,72,146,67,72,139,146,0.517985611510791,0.680555555555556,0.42654028436019,-0.162569944044764
"Chr08","1143708","G","A",78,85,163,160,107,81,188,160,0.430851063829787,0.521472392638037,0.527065527065527,-0.0906213288082496
"Chr08","1144403","A","C",50,72,122,149,78,99,177,149,0.559322033898305,0.590163934426229,0.42809364548495,-0.0308419005279245
"Chr08","1147158","T","C",43,57,100,160,61,68,129,160,0.527131782945736,0.57,0.454148471615721,-0.0428682170542635
"Chr08","1147209","G","A",38,64,102,140,65,75,140,140,0.535714285714286,0.627450980392157,0.425619834710744,-0.0917366946778712
"Chr08","1202067","A","T",42,66,108,139,49,66,115,139,0.573913043478261,0.611111111111111,0.408071748878924,-0.0371980676328503
"Chr08","1215625","C","T",60,91,151,160,80,87,167,160,0.520958083832335,0.602649006622517,0.440251572327044,-0.0816909227901812
"Chr08","1215643","T","C",86,71,157,140,81,77,158,140,0.487341772151899,0.452229299363057,0.53015873015873,0.0351124727888414
"Chr08","1215650","T","C",68,86,154,140,74,68,142,140,0.47887323943662,0.558441558441558,0.47972972972973,-0.0795683190049387
"Chr08","1215667","A","G",71,82,153,137,75,73,148,137,0.493243243243243,0.535947712418301,0.485049833887043,-0.0427044691750574
"Chr08","1215712","T","C",74,74,148,160,76,86,162,160,0.530864197530864,0.5,0.483870967741935,0.0308641975308642
"Chr08","1215781","C","T",61,54,115,160,61,94,155,160,0.606451612903226,0.469565217391304,0.451851851851852,0.136886395511921
"Chr08","1215830","C","T",50,54,104,160,82,67,149,160,0.449664429530201,0.519230769230769,0.521739130434783,-0.0695663397005679
"Chr08","1215832","A","G",55,49,104,160,69,82,151,160,0.543046357615894,0.471153846153846,0.486274509803922,0.0718925114620479
"Chr08","1217092","A","G",61,68,129,145,100,89,189,145,0.470899470899471,0.527131782945736,0.506289308176101,-0.0562323120462656
"Chr08","1223545","A","T",86,137,223,148,111,119,230,148,0.517391304347826,0.614349775784753,0.434878587196468,-0.0969584714369273
"Chr08","1223576","C","T",140,85,225,138,127,117,244,138,0.479508196721311,0.377777777777778,0.569296375266525,0.101730418943534
"Chr08","1225993","G","A",34,91,125,160,66,70,136,160,0.514705882352941,0.728,0.383141762452107,-0.213294117647059
"Chr08","1226069","T","G",37,49,86,160,62,62,124,160,0.5,0.569767441860465,0.471428571428571,-0.0697674418604651
"Chr08","1226342","G","A",33,43,76,144,43,50,93,144,0.537634408602151,0.565789473684211,0.449704142011834,-0.02815506508206
"Chr08","1226382","C","A",38,49,87,147,47,54,101,147,0.534653465346535,0.563218390804598,0.452127659574468,-0.028564925458063
"Chr08","1226392","A","T",40,48,88,146,48,51,99,146,0.515151515151515,0.545454545454545,0.470588235294118,-0.0303030303030303
"Chr08","1226398","T","C",43,47,90,150,49,50,99,150,0.505050505050505,0.522222222222222,0.486772486772487,-0.0171717171717172
"Chr08","1226615","T","C",34,27,61,136,45,46,91,136,0.505494505494505,0.442622950819672,0.519736842105263,0.0628715546748334
"Chr08","1227131","C","G",70,32,102,140,80,41,121,140,0.338842975206612,0.313725490196078,0.672645739910314,0.0251174850105331
"Chr08","1230783","T","C",44,38,82,154,60,42,102,154,0.411764705882353,0.463414634146341,0.565217391304348,-0.0516499282639886
"Chr08","1230824","G","T",51,78,129,136,64,91,155,136,0.587096774193548,0.604651162790698,0.404929577464789,-0.0175543885971493
"Chr08","1230863","C","A",62,50,112,136,88,56,144,136,0.388888888888889,0.446428571428571,0.5859375,-0.0575396825396826
"Chr08","1231360","TCAG","TCAT",70,53,123,160,66,81,147,160,0.551020408163265,0.430894308943089,0.503703703703704,0.120126099220176
"Chr08","1231373","G","A",65,55,120,144,66,79,145,144,0.544827586206897,0.458333333333333,0.494339622641509,0.0864942528735632
"Chr08","1233852","C","G",55,91,146,160,79,87,166,160,0.524096385542169,0.623287671232877,0.429487179487179,-0.0991912856907081
"Chr08","1233929","C","T",50,54,104,139,52,74,126,139,0.587301587301587,0.519230769230769,0.443478260869565,0.0680708180708181
"Chr08","1234285","A","C",61,27,88,139,50,29,79,139,0.367088607594937,0.306818181818182,0.664670658682635,0.0602704257767549
"Chr08","1234339","G","A",22,47,69,160,26,42,68,160,0.617647058823529,0.681159420289855,0.35036496350365,-0.0635123614663257
"Chr08","1234431","T","C",21,30,51,144,34,49,83,144,0.590361445783133,0.588235294117647,0.41044776119403,0.00212615166548547
"Chr08","1239899","T","G",64,47,111,144,68,51,119,144,0.428571428571429,0.423423423423423,0.573913043478261,0.00514800514800512
"Chr08","1250664","A","C",5,1,6,2,15,4,19,90,0.210526315789474,0.166666666666667,0.8,0.043859649122807
"Chr08","1252687","C","A",7,6,13,142,8,17,25,120,0.68,0.461538461538462,0.394736842105263,0.218461538461538
"Chr08","1253303","C","G",9,16,25,160,13,17,30,160,0.566666666666667,0.64,0.4,-0.0733333333333334
"Chr08","1253401","T","C",12,10,22,160,13,11,24,160,0.458333333333333,0.454545454545455,0.543478260869565,0.00378787878787878
"Chr08","1269033","T","C",60,98,158,137,96,83,179,137,0.463687150837989,0.620253164556962,0.462908011869436,-0.156566013718973
"Chr08","1352988","G","T",43,51,94,139,58,53,111,139,0.477477477477477,0.542553191489362,0.492682926829268,-0.0650757140118842
"Chr08","1390540","T","C",65,128,193,136,112,119,231,136,0.515151515151515,0.663212435233161,0.417452830188679,-0.148060920081646
"Chr08","1392222","C","T",79,56,135,160,93,79,172,160,0.459302325581395,0.414814814814815,0.560260586319218,0.0444875107665805
"Chr08","1393515","C","T",34,27,61,160,26,30,56,160,0.535714285714286,0.442622950819672,0.512820512820513,0.0930913348946136
"Chr08","1393851","C","T",40,17,57,147,33,32,65,147,0.492307692307692,0.298245614035088,0.598360655737705,0.194062078272605
"Chr08","1397151","C","T",67,117,184,160,117,105,222,160,0.472972972972973,0.635869565217391,0.45320197044335,-0.162896592244418
"Chr08","1398409","C","A",65,104,169,160,104,97,201,160,0.482587064676617,0.615384615384615,0.456756756756757,-0.132797550707998
"Chr08","1399388","T","C",45,81,126,160,83,104,187,160,0.556149732620321,0.642857142857143,0.408945686900958,-0.086707410236822
"Chr08","1400321","A","G",133,89,222,138,131,109,240,138,0.454166666666667,0.400900900900901,0.571428571428571,0.0532657657657657
"Chr08","1402997","A","G",41,60,101,141,57,80,137,141,0.583941605839416,0.594059405940594,0.411764705882353,-0.010117800101178
"Chr08","1403411","C","T",47,53,100,144,36,66,102,144,0.647058823529412,0.53,0.410891089108911,0.117058823529412
"Chr08","1403461","A","G",64,48,112,140,72,47,119,140,0.394957983193277,0.428571428571429,0.588744588744589,-0.0336134453781513
"Chr08","1403472","T","C",47,69,116,139,48,73,121,139,0.603305785123967,0.594827586206897,0.40084388185654,0.00847819891707036
"Chr08","1403598","A","T",61,80,141,141,66,80,146,141,0.547945205479452,0.567375886524823,0.442508710801394,-0.0194306810453707
"Chr08","1403973","A","G",18,55,73,151,45,49,94,151,0.521276595744681,0.753424657534247,0.377245508982036,-0.232148061789566
"Chr08","1404740","C","T",55,79,134,144,75,95,170,144,0.558823529411765,0.58955223880597,0.427631578947368,-0.0307287093942055
"Chr08","1405049","C","T",25,42,67,139,64,60,124,139,0.483870967741935,0.626865671641791,0.465968586387435,-0.142994703899856
"Chr08","1405065","T","G",26,45,71,146,66,60,126,146,0.476190476190476,0.633802816901408,0.467005076142132,-0.157612340710932
"Chr08","1405086","A","G",31,44,75,160,57,53,110,160,0.481818181818182,0.586666666666667,0.475675675675676,-0.104848484848485
"Chr08","1405095","A","G",33,47,80,160,60,57,117,160,0.487179487179487,0.5875,0.472081218274112,-0.100320512820513
"Chr08","1405168","T","C",47,67,114,139,50,65,115,139,0.565217391304348,0.587719298245614,0.423580786026201,-0.0225019069412663
"Chr08","1405362","C","T",28,31,59,142,33,31,64,142,0.484375,0.525423728813559,0.495934959349593,-0.0410487288135594
"Chr08","1405381","A","T",37,24,61,144,30,35,65,144,0.538461538461538,0.39344262295082,0.531746031746032,0.145018915510719
"Chr08","1405424","G","A",35,27,62,150,25,31,56,150,0.553571428571429,0.435483870967742,0.508474576271186,0.118087557603687
"Chr08","1405468","C","T",20,25,45,160,19,25,44,160,0.568181818181818,0.555555555555556,0.438202247191011,0.0126262626262627
"Chr08","1405725","C","T",25,22,47,145,34,23,57,145,0.403508771929825,0.468085106382979,0.567307692307692,-0.0645763344531542
"Chr08","1405914","C","T",19,19,38,160,25,13,38,160,0.342105263157895,0.5,0.578947368421053,-0.157894736842105
"Chr08","1405918","T","G",19,20,39,160,14,25,39,160,0.641025641025641,0.512820512820513,0.423076923076923,0.128205128205128
"Chr08","1407283","C","A",21,20,41,160,20,15,35,160,0.428571428571429,0.48780487804878,0.539473684210526,-0.0592334494773519
"Chr08","1407329","G","C",25,30,55,148,39,25,64,148,0.390625,0.545454545454545,0.53781512605042,-0.154829545454545
"Chr08","1407424","G","A",34,35,69,143,47,35,82,143,0.426829268292683,0.507246376811594,0.536423841059603,-0.0804171085189113
"Chr08","1407453","G","A",33,36,69,160,43,43,86,160,0.5,0.521739130434783,0.490322580645161,-0.0217391304347826
"Chr08","1407486","A","G",49,36,85,145,40,47,87,145,0.540229885057471,0.423529411764706,0.517441860465116,0.116700473292765
"Chr08","1409190","G","A",56,55,111,160,64,80,144,160,0.555555555555556,0.495495495495495,0.470588235294118,0.0600600600600601
"Chr08","1409274","G","T",58,44,102,139,74,72,146,139,0.493150684931507,0.431372549019608,0.532258064516129,0.061778135911899
"Chr08","1415256","G","A",47,31,78,160,77,66,143,160,0.461538461538462,0.397435897435897,0.561085972850679,0.0641025641025642
"Chr08","1416687","C","T",57,30,87,160,39,49,88,160,0.556818181818182,0.344827586206897,0.548571428571429,0.211990595611285
"Chr08","1416716","G","T",22,37,59,140,36,28,64,140,0.4375,0.627118644067797,0.471544715447154,-0.189618644067797
"Chr08","1417488","C","T",81,54,135,140,75,64,139,140,0.460431654676259,0.4,0.569343065693431,0.060431654676259
"Chr08","1417507","T","C",74,67,141,142,76,64,140,142,0.457142857142857,0.475177304964539,0.533807829181495,-0.0180344478216819
"Chr08","1417533","T","C",72,66,138,142,80,61,141,142,0.432624113475177,0.478260869565217,0.544802867383513,-0.0456367560900401
"Chr08","1417643","A","C",60,51,111,154,65,41,106,154,0.386792452830189,0.459459459459459,0.576036866359447,-0.0726670066292708
"Chr08","1418348","T","G",40,68,108,142,77,100,177,142,0.564971751412429,0.62962962962963,0.410526315789474,-0.0646578782172003
"Chr08","1418359","C","T",54,37,91,160,91,67,158,160,0.424050632911392,0.406593406593407,0.582329317269076,0.0174572263179858
"Chr08","1418373","A","G",39,58,97,142,71,84,155,142,0.541935483870968,0.597938144329897,0.436507936507937,-0.0560026604589291
"Chr08","1418403","C","T",55,38,93,160,85,80,165,160,0.484848484848485,0.408602150537634,0.542635658914729,0.0762463343108504
"Chr08","1418680","G","A",70,53,123,137,85,96,181,137,0.530386740331492,0.430894308943089,0.509868421052632,0.0994924313884022
"Chr08","1418786","A","C",62,30,92,160,75,67,142,160,0.471830985915493,0.326086956521739,0.585470085470085,0.145744029393754
"Chr08","1418831","C","A",62,26,88,139,68,51,119,139,0.428571428571429,0.295454545454545,0.628019323671498,0.133116883116883
"Chr08","1418832","C","T",23,62,85,144,48,66,114,144,0.578947368421053,0.729411764705882,0.35678391959799,-0.15046439628483
"Chr08","1418845","A","C",55,24,79,160,66,48,114,160,0.421052631578947,0.30379746835443,0.626943005181347,0.117255163224517
"Chr08","1419515","G","C",22,22,44,160,33,40,73,160,0.547945205479452,0.5,0.47008547008547,0.047945205479452
"Chr08","1419527","C","T",22,22,44,147,33,41,74,147,0.554054054054054,0.5,0.466101694915254,0.0540540540540541
"Chr08","1419614","C","T",38,50,88,160,32,49,81,160,0.604938271604938,0.568181818181818,0.414201183431953,0.0367564534231201
"Chr08","1419721","C","G",31,41,72,148,49,53,102,148,0.519607843137255,0.569444444444444,0.459770114942529,-0.0498366013071895
"Chr08","1419761","G","A",17,38,55,139,59,62,121,139,0.512396694214876,0.690909090909091,0.431818181818182,-0.178512396694215
"Chr08","1419838","C","T",40,21,61,145,66,41,107,145,0.383177570093458,0.344262295081967,0.630952380952381,0.0389152750114907
"Chr08","1420170","G","A",57,36,93,139,54,86,140,139,0.614285714285714,0.387096774193548,0.476394849785408,0.227188940092166
"Chr08","1420176","T","C",63,38,101,146,62,88,150,146,0.586666666666667,0.376237623762376,0.49800796812749,0.21042904290429
"Chr08","1420208","C","T",45,53,98,160,72,62,134,160,0.462686567164179,0.540816326530612,0.504310344827586,-0.0781297593664332
"Chr08","1420227","A","C",52,50,102,141,57,67,124,141,0.540322580645161,0.490196078431373,0.482300884955752,0.0501265022137887
"Chr08","1420233","A","T",47,52,99,141,55,65,120,141,0.541666666666667,0.525252525252525,0.465753424657534,0.0164141414141413
"Chr08","1420330","A","G",60,51,111,160,57,57,114,160,0.5,0.459459459459459,0.52,0.0405405405405405
"Chr08","1420355","T","C",67,50,117,142,57,74,131,142,0.564885496183206,0.427350427350427,0.5,0.137535068832779
"Chr08","1420361","T","A",85,50,135,160,71,76,147,160,0.517006802721088,0.37037037037037,0.553191489361702,0.146636432350718
"Chr08","1420432","T","C",75,90,165,138,87,173,260,138,0.665384615384615,0.545454545454545,0.381176470588235,0.11993006993007
"Chr08","1420467","G","A",86,51,137,136,100,84,184,136,0.456521739130435,0.372262773722628,0.579439252336449,0.084258965407807
"Chr08","1420490","C","G",76,58,134,160,93,91,184,160,0.494565217391304,0.432835820895522,0.531446540880503,0.061729396495782
"Chr08","1420654","C","A",59,38,97,160,58,76,134,160,0.567164179104478,0.391752577319588,0.506493506493506,0.17541160178489
"Chr08","1421334","G","A",59,76,135,160,69,78,147,160,0.530612244897959,0.562962962962963,0.453900709219858,-0.0323507180650038
"Chr08","1421445","T","G",81,53,134,140,72,79,151,140,0.52317880794702,0.395522388059701,0.536842105263158,0.127656419887318
"Chr08","1421480","T","C",76,55,131,142,68,91,159,142,0.572327044025157,0.419847328244275,0.496551724137931,0.152479715780882
"Chr08","1421485","T","C",83,54,137,139,71,92,163,139,0.56441717791411,0.394160583941606,0.513333333333333,0.170256593972505
"Chr08","1423962","C","A",79,39,118,136,87,66,153,136,0.431372549019608,0.330508474576271,0.612546125461255,0.100864074443337
"Chr08","1424011","A","G",93,74,167,160,104,116,220,160,0.527272727272727,0.44311377245509,0.509043927648579,0.0841589548176374
"Chr08","1424017","A","C",94,68,162,160,110,109,219,160,0.497716894977169,0.419753086419753,0.535433070866142,0.0779638085574159
"Chr08","1424060","G","T",109,90,199,160,109,124,233,160,0.532188841201717,0.452261306532663,0.50462962962963,0.0799275346690534
"Chr08","1424099","G","A",117,81,198,160,139,112,251,160,0.446215139442231,0.409090909090909,0.570155902004454,0.037124230351322
"Chr08","1424104","G","C",120,83,203,137,138,103,241,137,0.427385892116183,0.408866995073892,0.581081081081081,0.0185188970422909
"Chr08","1424117","G","C",123,77,200,160,134,100,234,160,0.427350427350427,0.385,0.592165898617512,0.0423504273504273
"Chr08","1424141","T","C",115,76,191,141,113,92,205,141,0.448780487804878,0.397905759162304,0.575757575757576,0.0508747286425744
"Chr08","1424168","T","G",125,88,213,146,118,108,226,146,0.47787610619469,0.413145539906103,0.553530751708428,0.064730566288587
"Chr08","1424181","A","C",109,73,182,160,110,103,213,160,0.483568075117371,0.401098901098901,0.554430379746835,0.0824691740184698
"Chr08","1424337","A","G",119,83,202,160,115,108,223,160,0.484304932735426,0.410891089108911,0.550588235294118,0.0734138436265152
"Chr08","1424363","T","C",110,70,180,139,106,95,201,139,0.472636815920398,0.388888888888889,0.566929133858268,0.0837479270315091
"Chr08","1424372","A","G",112,76,188,136,110,104,214,136,0.485981308411215,0.404255319148936,0.552238805970149,0.0817259892622788
"Chr08","1424504","C","A",121,78,199,141,121,121,242,141,0.5,0.391959798994975,0.54875283446712,0.108040201005025
"Chr08","1424582","G","A",120,79,199,160,122,113,235,160,0.480851063829787,0.396984924623116,0.557603686635945,0.0838661392066716
"Chr08","1424738","G","A",120,88,208,138,132,116,248,138,0.467741935483871,0.423076923076923,0.552631578947368,0.0446650124069479
"Chr08","1424747","A","G",135,100,235,160,153,128,281,160,0.455516014234875,0.425531914893617,0.558139534883721,0.0299840993412584
"Chr08","1425450","T","A",70,51,121,160,97,88,185,160,0.475675675675676,0.421487603305785,0.545751633986928,0.0541880723698906
"Chr08","1425456","T","A",70,51,121,160,95,91,186,160,0.489247311827957,0.421487603305785,0.537459283387622,0.0677597085221719
"Chr08","1425944","T","G",101,62,163,137,89,91,180,137,0.505555555555556,0.380368098159509,0.553935860058309,0.125187457396046
"Chr08","1426689","A","G",66,56,122,160,109,75,184,160,0.407608695652174,0.459016393442623,0.571895424836601,-0.0514076977904491
"Chr08","1426944","G","A",82,47,129,160,75,70,145,160,0.482758620689655,0.364341085271318,0.572992700729927,0.118417535418337
"Chr08","1426995","G","A",82,51,133,140,90,69,159,140,0.433962264150943,0.383458646616541,0.589041095890411,0.0505036175344021
"Chr08","1427154","C","A",61,52,113,160,61,66,127,160,0.519685039370079,0.460176991150442,0.508333333333333,0.0595080482196362
"Chr08","1427165","C","T",74,68,142,140,71,66,137,140,0.481751824817518,0.47887323943662,0.519713261648746,0.00287858538089858
"Chr08","1427211","C","G",61,66,127,160,58,45,103,160,0.436893203883495,0.519685039370079,0.517391304347826,-0.0827918354865836
"Chr08","1427329","A","T",40,68,108,143,54,38,92,143,0.41304347826087,0.62962962962963,0.47,-0.21658615136876
"Chr08","1427354","T","C",44,71,115,142,55,34,89,142,0.382022471910112,0.617391304347826,0.485294117647059,-0.235368832437714
"Chr08","1427393","C","A",71,57,128,160,42,60,102,160,0.588235294117647,0.4453125,0.491304347826087,0.142922794117647
"Chr08","1427456","T","C",68,58,126,160,51,47,98,160,0.479591836734694,0.46031746031746,0.53125,0.0192743764172336
"Chr08","1427461","G","A",59,68,127,160,48,51,99,160,0.515151515151515,0.535433070866142,0.473451327433628,-0.0202815557146266
"Chr08","1427472","C","G",72,65,137,139,50,49,99,139,0.494949494949495,0.474452554744526,0.516949152542373,0.0204969402049694
"Chr08","1427519","C","T",78,67,145,160,60,48,108,160,0.444444444444444,0.462068965517241,0.545454545454545,-0.0176245210727969
"Chr08","1427699","C","T",47,57,104,139,63,37,100,139,0.37,0.548076923076923,0.53921568627451,-0.178076923076923
"Chr08","1427717","T","G",45,69,114,140,60,42,102,140,0.411764705882353,0.605263157894737,0.486111111111111,-0.193498452012384
"Chr08","1427763","G","C",48,70,118,141,64,66,130,141,0.507692307692308,0.593220338983051,0.451612903225806,-0.0855280312907432
"Chr08","1427920","C","T",57,69,126,136,69,99,168,136,0.589285714285714,0.547619047619048,0.428571428571429,0.0416666666666666
"Chr08","1427947","G","A",70,59,129,160,99,72,171,160,0.421052631578947,0.457364341085271,0.563333333333333,-0.036311709506324
"Chr08","1427965","C","A",68,57,125,160,98,63,161,160,0.391304347826087,0.456,0.58041958041958,-0.064695652173913
"Chr08","1427972","C","T",56,68,124,160,62,99,161,160,0.614906832298137,0.548387096774194,0.414035087719298,0.0665197355239432
"Chr08","1428331","C","T",77,102,179,142,81,116,197,142,0.588832487309645,0.569832402234637,0.420212765957447,0.0190000850750078
"Chr08","1428369","C","T",59,81,140,152,69,85,154,152,0.551948051948052,0.578571428571429,0.435374149659864,-0.0266233766233767
"Chr08","1428385","C","A",69,53,122,160,86,71,157,160,0.452229299363057,0.434426229508197,0.555555555555556,0.0178030698548606
"Chr08","1428481","C","T",52,60,112,160,62,80,142,160,0.563380281690141,0.535714285714286,0.448818897637795,0.0276659959758552
"Chr08","1430144","A","G",79,101,180,160,105,130,235,160,0.553191489361702,0.561111111111111,0.443373493975904,-0.00791962174940897
"Chr08","1430488","C","A",79,63,142,160,108,69,177,160,0.389830508474576,0.443661971830986,0.586206896551724,-0.0538314633564096
"Chr08","1430515","G","A",101,74,175,160,122,80,202,160,0.396039603960396,0.422857142857143,0.591511936339523,-0.0268175388967468
"Chr08","1430851","T","G",65,93,158,141,108,120,228,141,0.526315789473684,0.588607594936709,0.448186528497409,-0.0622918054630247
"Chr08","1431263","T","C",158,131,289,160,182,166,348,160,0.477011494252874,0.453287197231834,0.533751962323391,0.0237242970210396
"Chr08","1431459","A","G",63,39,102,160,58,47,105,160,0.447619047619048,0.382352941176471,0.584541062801932,0.0652661064425771
"Chr08","1431643","T","A",103,79,182,136,163,104,267,136,0.389513108614232,0.434065934065934,0.592427616926503,-0.0445528254517019
"Chr08","1431649","C","T",96,83,179,160,163,111,274,160,0.405109489051095,0.463687150837989,0.571743929359823,-0.0585776617868939
"Chr08","1431654","T","A",99,83,182,140,168,110,278,140,0.39568345323741,0.456043956043956,0.580434782608696,-0.060360502806546
"Chr08","1431659","G","A",100,84,184,139,167,112,279,139,0.401433691756272,0.456521739130435,0.576673866090713,-0.0550880473741623
"Chr08","1431701","G","C",65,87,152,160,109,130,239,160,0.543933054393305,0.572368421052632,0.445012787723785,-0.0284353666593261
"Chr08","1431870","A","C",88,79,167,160,102,118,220,160,0.536363636363636,0.473053892215569,0.490956072351421,0.0633097441480675
"Chr08","1431878","A","G",87,81,168,137,109,116,225,137,0.515555555555556,0.482142857142857,0.498727735368957,0.0334126984126984
"Chr08","1431898","G","A",93,79,172,160,96,107,203,160,0.527093596059113,0.459302325581395,0.504,0.067791270477718
"Chr08","1431916","T","C",80,68,148,160,86,100,186,160,0.537634408602151,0.459459459459459,0.497005988023952,0.078174949142691
"Chr08","1432281","G","A",49,48,97,160,58,67,125,160,0.536,0.494845360824742,0.481981981981982,0.0411546391752577
"Chr08","1432300","C","T",42,38,80,142,45,62,107,142,0.579439252336449,0.475,0.46524064171123,0.104439252336449
"Chr08","1432384","T","C",47,36,83,160,62,28,90,160,0.311111111111111,0.433734939759036,0.630057803468208,-0.122623828647925
"Chr08","1432692","A","G",84,59,143,160,100,72,172,160,0.418604651162791,0.412587412587413,0.584126984126984,0.00601723857537811
"Chr08","1432739","C","T",58,55,113,146,77,65,142,146,0.457746478873239,0.486725663716814,0.529411764705882,-0.0289791848435747
"Chr08","1432780","A","T",64,51,115,136,100,56,156,136,0.358974358974359,0.443478260869565,0.605166051660517,-0.0845039018952062
"Chr08","1432949","A","C",65,36,101,160,53,60,113,160,0.530973451327434,0.356435643564356,0.551401869158878,0.174537807763077
"Chr08","1433259","G","A",117,63,180,160,99,73,172,160,0.424418604651163,0.35,0.613636363636364,0.0744186046511628
"Chr08","1433299","C","G",112,71,183,145,111,100,211,145,0.4739336492891,0.387978142076503,0.565989847715736,0.0859555072125968
"Chr08","1433320","C","A",121,68,189,142,125,98,223,142,0.439461883408072,0.35978835978836,0.597087378640777,0.079673523619712
"Chr08","1433376","A","C",92,54,146,138,115,84,199,138,0.422110552763819,0.36986301369863,0.6,0.052247539065189
"Chr08","1433398","T","G",48,73,121,140,78,101,179,140,0.564245810055866,0.603305785123967,0.42,-0.039059975068101
"Chr08","1433502","C","G",78,61,139,160,89,88,177,160,0.497175141242938,0.438848920863309,0.528481012658228,0.0583262203796285
"Chr08","1433568","T","C",75,74,149,160,87,75,162,160,0.462962962962963,0.496644295302013,0.520900321543408,-0.0336813323390505
"Chr08","1433584","C","A",70,74,144,160,70,84,154,160,0.545454545454545,0.513888888888889,0.469798657718121,0.0315656565656566
"Chr08","1433681","T","C",85,65,150,160,101,73,174,160,0.419540229885057,0.433333333333333,0.574074074074074,-0.0137931034482759
"Chr08","1433722","C","G",92,57,149,160,105,74,179,160,0.41340782122905,0.38255033557047,0.600609756097561,0.0308574856585805
"Chr08","1433833","C","T",90,55,145,150,90,114,204,150,0.558823529411765,0.379310344827586,0.515759312320917,0.179513184584179
"Chr08","1433875","A","G",91,54,145,160,96,112,208,160,0.538461538461538,0.372413793103448,0.529745042492918,0.16604774535809
"Chr08","1433910","G","A",89,55,144,136,93,96,189,136,0.507936507936508,0.381944444444444,0.546546546546547,0.125992063492063
"Chr08","1433921","T","G",86,55,141,160,92,97,189,160,0.513227513227513,0.390070921985816,0.539393939393939,0.123156591241698
"Chr08","1433988","G","A",79,41,120,139,80,82,162,139,0.506172839506173,0.341666666666667,0.563829787234043,0.164506172839506
"Chr08","1433997","C","A",73,47,120,160,83,84,167,160,0.502994011976048,0.391666666666667,0.543554006968641,0.111327345309381
"Chr08","1434022","C","T",79,43,122,160,72,84,156,160,0.538461538461538,0.352459016393443,0.543165467625899,0.186002522068096
"Chr08","1434106","T","C",71,32,103,143,67,75,142,143,0.528169014084507,0.310679611650485,0.563265306122449,0.217489402434022
"Chr08","1434126","A","C",59,37,96,160,64,73,137,160,0.532846715328467,0.385416666666667,0.527896995708155,0.1474300486618
"Chr08","1434140","A","G",60,39,99,147,66,70,136,147,0.514705882352941,0.393939393939394,0.536170212765957,0.120766488413547
"Chr08","1434167","C","T",55,44,99,143,69,81,150,143,0.54,0.444444444444444,0.497991967871486,0.0955555555555556
"Chr08","1434241","C","T",72,48,120,151,70,90,160,151,0.5625,0.4,0.507142857142857,0.1625
"Chr08","1434347","C","G",88,43,131,160,85,105,190,160,0.552631578947368,0.32824427480916,0.538940809968847,0.224387304138208
"Chr08","1434388","T","C",68,40,108,160,65,88,153,160,0.57516339869281,0.37037037037037,0.509578544061303,0.20479302832244
"Chr08","1434401","C","G",68,44,112,160,60,96,156,160,0.615384615384615,0.392857142857143,0.477611940298507,0.222527472527473
"Chr08","1434409","A","G",69,45,114,160,71,97,168,160,0.577380952380952,0.394736842105263,0.49645390070922,0.182644110275689
"Chr08","1434418","G","A",70,47,117,160,74,99,173,160,0.572254335260116,0.401709401709402,0.496551724137931,0.170544933550714
"Chr08","1434481","A","C",55,27,82,160,55,67,122,160,0.549180327868853,0.329268292682927,0.53921568627451,0.219912035185926
"Chr08","1434493","A","T",61,31,92,148,56,59,115,148,0.51304347826087,0.33695652173913,0.565217391304348,0.176086956521739
"Chr08","1434514","G","A",63,28,91,144,56,59,115,144,0.51304347826087,0.307692307692308,0.577669902912621,0.205351170568562
"Chr08","1434520","C","T",60,31,91,155,55,55,110,155,0.5,0.340659340659341,0.572139303482587,0.159340659340659
"Chr08","1434699","A","G",83,56,139,160,71,62,133,160,0.466165413533835,0.402877697841727,0.566176470588235,0.0632877156921079
"Chr08","1434715","G","C",92,61,153,160,74,67,141,160,0.475177304964539,0.398692810457516,0.564625850340136,0.0764844945070227
"Chr08","1434766","G","C",88,64,152,160,86,69,155,160,0.445161290322581,0.421052631578947,0.566775244299674,0.0241086587436333
"Chr08","1434829","A","G",90,51,141,138,82,84,166,138,0.506024096385542,0.361702127659574,0.560260586319218,0.144321968725968
"Chr08","1434856","A","G",73,40,113,141,75,70,145,141,0.482758620689655,0.353982300884956,0.573643410852713,0.128776319804699
"Chr08","1434866","G","A",61,38,99,160,65,72,137,160,0.525547445255474,0.383838383838384,0.533898305084746,0.141709061417091
"Chr08","1434891","C","T",54,41,95,160,61,61,122,160,0.5,0.431578947368421,0.529953917050691,0.0684210526315789
"Chr08","1434912","C","T",47,37,84,139,47,58,105,139,0.552380952380952,0.44047619047619,0.497354497354497,0.111904761904762
"Chr08","1435768","A","G",60,28,88,160,58,47,105,160,0.447619047619048,0.318181818181818,0.61139896373057,0.129437229437229
"Chr08","1435922","G","C",56,21,77,160,49,51,100,160,0.51,0.272727272727273,0.593220338983051,0.237272727272727
"Chr08","1435938","A","G",55,21,76,160,49,46,95,160,0.484210526315789,0.276315789473684,0.608187134502924,0.207894736842105
"Chr08","1435951","T","C",54,22,76,139,52,49,101,139,0.485148514851485,0.289473684210526,0.598870056497175,0.195674830640959
"Chr08","1436549","C","G",27,12,39,160,21,25,46,160,0.543478260869565,0.307692307692308,0.564705882352941,0.235785953177257
"Chr08","1439224","C","T",83,141,224,141,126,124,250,141,0.496,0.629464285714286,0.440928270042194,-0.133464285714286
"Chr08","1440207","A","G",116,70,186,160,123,88,211,160,0.417061611374408,0.376344086021505,0.602015113350126,0.0407175253529022
"Chr08","1441583","T","A",35,56,91,160,44,46,90,160,0.511111111111111,0.615384615384615,0.43646408839779,-0.104273504273504
"Chr08","1443097","G","A",46,112,158,140,103,103,206,140,0.5,0.708860759493671,0.409340659340659,-0.208860759493671
"Chr08","1446072","C","T",78,37,115,160,84,77,161,160,0.478260869565217,0.321739130434783,0.58695652173913,0.156521739130435
"Chr08","1447815","G","T",25,21,46,160,29,19,48,160,0.395833333333333,0.456521739130435,0.574468085106383,-0.0606884057971014
"Chr08","1480898","A","C",49,29,78,146,68,53,121,146,0.43801652892562,0.371794871794872,0.587939698492462,0.066221657130748
"Chr08","1484264","C","T",98,51,149,160,104,79,183,160,0.431693989071038,0.342281879194631,0.608433734939759,0.0894121098764074
"Chr08","1487856","A","C",34,56,90,137,63,75,138,137,0.543478260869565,0.622222222222222,0.425438596491228,-0.078743961352657
"Chr08","1493722","C","A",35,35,70,141,40,31,71,141,0.436619718309859,0.5,0.531914893617021,-0.0633802816901409
"Chr08","1493874","T","C",38,47,85,160,51,52,103,160,0.504854368932039,0.552941176470588,0.473404255319149,-0.0480868075385494
"Chr08","1496416","G","A",29,33,62,160,34,48,82,160,0.585365853658537,0.532258064516129,0.4375,0.0531077891424075
"Chr08","1496421","C","G",33,32,65,160,33,48,81,160,0.592592592592593,0.492307692307692,0.452054794520548,0.1002849002849
"Chr08","1496428","T","C",39,34,73,146,43,51,94,146,0.542553191489362,0.465753424657534,0.491017964071856,0.0767997668318274
"Chr08","1496445","C","T",42,30,72,160,40,50,90,160,0.555555555555556,0.416666666666667,0.506172839506173,0.138888888888889
"Chr08","1496510","T","C",29,25,54,160,48,40,88,160,0.454545454545455,0.462962962962963,0.542253521126761,-0.00841750841750843
"Chr08","1496932","C","T",17,15,32,107,54,31,85,141,0.364705882352941,0.46875,0.606837606837607,-0.104044117647059
"Chr08","1496954","A","G",16,18,34,150,38,35,73,150,0.479452054794521,0.529411764705882,0.504672897196262,-0.0499597099113618
"Chr08","1496963","G","A",16,19,35,141,39,34,73,141,0.465753424657534,0.542857142857143,0.509259259259259,-0.0771037181996086
"Chr08","1497056","G","A",16,19,35,143,19,22,41,143,0.536585365853659,0.542857142857143,0.460526315789474,-0.00627177700348425
"Chr08","1497062","T","C",17,22,39,145,26,25,51,145,0.490196078431373,0.564102564102564,0.477777777777778,-0.0739064856711916
"Chr08","1497114","G","C",15,21,36,145,24,18,42,145,0.428571428571429,0.583333333333333,0.5,-0.154761904761905
"Chr08","1497364","A","G",29,24,53,160,27,18,45,160,0.4,0.452830188679245,0.571428571428571,-0.0528301886792453
"Chr08","1497383","G","A",28,31,59,140,32,20,52,140,0.384615384615385,0.525423728813559,0.540540540540541,-0.140808344198175
"Chr08","1497425","T","C",16,36,52,140,30,31,61,140,0.508196721311475,0.692307692307692,0.407079646017699,-0.184110970996217
"Chr08","1499599","C","T",48,62,110,146,70,83,153,146,0.542483660130719,0.563636363636364,0.448669201520913,-0.0211527035056447
"Chr08","1499616","G","A",50,53,103,160,78,70,148,160,0.472972972972973,0.514563106796116,0.50996015936255,-0.0415901338231435
"Chr08","1499631","C","T",44,62,106,160,76,81,157,160,0.515923566878981,0.584905660377358,0.456273764258555,-0.0689820934983776
"Chr08","1499656","T","A",46,58,104,136,86,80,166,136,0.481927710843373,0.557692307692308,0.488888888888889,-0.0757645968489342
"Chr08","1499668","G","A",37,33,70,151,86,49,135,151,0.362962962962963,0.471428571428571,0.6,-0.108465608465608
"Chr08","1499799","A","G",30,42,72,160,60,62,122,160,0.508196721311475,0.583333333333333,0.463917525773196,-0.075136612021858
"Chr08","1499808","C","T",30,41,71,140,60,57,117,140,0.487179487179487,0.577464788732394,0.478723404255319,-0.0902853015529072
"Chr08","1499874","A","G",36,36,72,141,51,47,98,141,0.479591836734694,0.5,0.511764705882353,-0.0204081632653061
"Chr08","1499917","A","G",37,35,72,141,60,51,111,141,0.459459459459459,0.486111111111111,0.530054644808743,-0.0266516516516516
"Chr08","1499929","A","G",38,34,72,140,66,55,121,140,0.454545454545455,0.472222222222222,0.538860103626943,-0.0176767676767677
"Chr08","1500032","A","C",36,50,86,160,66,67,133,160,0.503759398496241,0.581395348837209,0.465753424657534,-0.0776359503409687
"Chr08","1500090","G","C",37,42,79,160,60,54,114,160,0.473684210526316,0.531645569620253,0.50259067357513,-0.0579613590939373
"Chr08","1500464","T","G",35,40,75,160,51,35,86,160,0.406976744186047,0.533333333333333,0.53416149068323,-0.126356589147287
"Chr08","1500487","A","C",39,46,85,160,50,42,92,160,0.456521739130435,0.541176470588235,0.502824858757062,-0.0846547314578005
"Chr08","1500556","G","A",39,61,100,160,36,63,99,160,0.636363636363636,0.61,0.376884422110553,0.0263636363636364
"Chr08","1500575","A","G",38,60,98,160,36,62,98,160,0.63265306122449,0.612244897959184,0.377551020408163,0.0204081632653061
"Chr08","1500822","C","T",35,23,58,139,42,35,77,139,0.454545454545455,0.396551724137931,0.57037037037037,0.0579937304075235
"Chr08","1500851","C","T",25,29,54,160,31,35,66,160,0.53030303030303,0.537037037037037,0.466666666666667,-0.00673400673400681
"Chr08","1500862","A","C",27,27,54,160,31,35,66,160,0.53030303030303,0.5,0.483333333333333,0.0303030303030303
"Chr08","1500884","G","T",32,27,59,143,31,35,66,143,0.53030303030303,0.457627118644068,0.504,0.0726759116589625
"Chr08","1500977","C","A",31,27,58,138,29,38,67,138,0.567164179104478,0.46551724137931,0.48,0.101646937725167
"Chr08","1501028","C","A",24,34,58,160,31,38,69,160,0.550724637681159,0.586206896551724,0.433070866141732,-0.0354822588705647
"Chr08","1501046","T","C",20,28,48,146,27,33,60,146,0.55,0.583333333333333,0.435185185185185,-0.0333333333333333
"Chr08","1501811","G","A",32,27,59,143,38,38,76,143,0.5,0.457627118644068,0.518518518518518,0.0423728813559322
"Chr08","1504678","G","A",82,65,147,140,93,73,166,140,0.439759036144578,0.442176870748299,0.559105431309904,-0.00241783460372103
"Chr08","1504850","T","C",69,42,111,160,86,46,132,160,0.348484848484849,0.378378378378378,0.637860082304527,-0.0298935298935299
"Chr08","1505647","G","A",25,22,47,160,32,41,73,160,0.561643835616438,0.468085106382979,0.475,0.0935587292334596
"Chr08","1506488","G","A",35,34,69,160,60,55,115,160,0.478260869565217,0.492753623188406,0.516304347826087,-0.0144927536231884
"Chr08","1507252","G","C",84,66,150,136,83,100,183,136,0.546448087431694,0.44,0.501501501501502,0.106448087431694
"Chr08","1507319","A","G",83,55,138,160,95,85,180,160,0.472222222222222,0.398550724637681,0.559748427672956,0.0736714975845411
"Chr08","1507748","C","T",65,49,114,160,54,67,121,160,0.553719008264463,0.429824561403509,0.506382978723404,0.123894446860954
"Chr08","1508351","C","A",14,32,46,143,26,29,55,143,0.527272727272727,0.695652173913043,0.396039603960396,-0.168379446640316
"Chr08","1508455","G","T",25,51,76,140,34,36,70,140,0.514285714285714,0.671052631578947,0.404109589041096,-0.156766917293233
"Chr08","1508489","G","T",29,53,82,160,43,33,76,160,0.434210526315789,0.646341463414634,0.455696202531646,-0.212130937098845
"Chr08","1509304","G","A",45,51,96,140,49,47,96,140,0.489583333333333,0.53125,0.489583333333333,-0.0416666666666667
"Chr08","1509777","C","T",53,112,165,148,92,124,216,148,0.574074074074074,0.678787878787879,0.380577427821522,-0.104713804713805
"Chr08","1510039","G","A",34,79,113,160,89,73,162,160,0.450617283950617,0.699115044247788,0.447272727272727,-0.24849776029717
"Chr08","1510566","C","T",66,51,117,141,82,57,139,141,0.410071942446043,0.435897435897436,0.578125,-0.0258254934513927
"Chr08","1510598","C","T",69,47,116,145,68,51,119,145,0.428571428571429,0.405172413793103,0.582978723404255,0.0233990147783251
"Chr08","1510756","C","T",63,97,160,160,107,122,229,160,0.532751091703057,0.60625,0.437017994858612,-0.0734989082969432
"Chr08","1510940","C","T",54,82,136,136,89,88,177,136,0.497175141242938,0.602941176470588,0.456869009584665,-0.10576603522765
"Chr08","1511241","G","T",91,56,147,138,89,72,161,138,0.447204968944099,0.380952380952381,0.584415584415584,0.0662525879917185
"Chr08","1511420","G","A",45,64,109,147,88,84,172,147,0.488372093023256,0.587155963302752,0.473309608540925,-0.0987838702794965
"Chr08","1512378","C","A",104,54,158,136,83,96,179,136,0.536312849162011,0.341772151898734,0.554896142433234,0.194540697263277
"Chr08","1512849","G","A",39,68,107,152,72,76,148,152,0.513513513513513,0.635514018691589,0.435294117647059,-0.122000505178075
"Chr08","1512932","G","A",87,66,153,160,95,73,168,160,0.43452380952381,0.431372549019608,0.566978193146417,0.00315126050420167
"Chr08","1513943","C","T",54,43,97,139,65,52,117,139,0.444444444444444,0.443298969072165,0.55607476635514,0.00114547537227949
"Chr08","1514304","T","C",68,39,107,160,56,81,137,160,0.591240875912409,0.364485981308411,0.508196721311475,0.226754894603998
"Chr08","1514390","G","A",63,25,88,160,47,51,98,160,0.520408163265306,0.284090909090909,0.591397849462366,0.236317254174397
"Chr08","1514968","T","C",51,31,82,142,47,46,93,142,0.494623655913978,0.378048780487805,0.56,0.116574875426174
"Chr08","1514980","T","A",47,32,79,140,43,52,95,140,0.547368421052632,0.40506329113924,0.517241379310345,0.142305129913391
"Chr08","1515060","G","A",43,34,77,151,47,45,92,151,0.489130434782609,0.441558441558442,0.532544378698225,0.0475719932241672
"Chr08","1515073","A","G",44,29,73,160,44,43,87,160,0.494252873563218,0.397260273972603,0.55,0.0969925995906157
"Chr08","1515459","C","T",61,35,96,160,70,54,124,160,0.435483870967742,0.364583333333333,0.595454545454545,0.0709005376344086
"Chr08","1515519","C","G",48,52,100,139,65,61,126,139,0.484126984126984,0.52,0.5,-0.0358730158730159
"Chr08","1515635","T","C",67,53,120,160,69,59,128,160,0.4609375,0.441666666666667,0.548387096774194,0.0192708333333333
"Chr08","1515640","C","G",74,53,127,140,74,61,135,140,0.451851851851852,0.417322834645669,0.564885496183206,0.0345290172061826
"Chr08","1515671","C","A",63,86,149,138,83,84,167,138,0.502994011976048,0.577181208053691,0.462025316455696,-0.0741871960776435
"Chr08","1515705","C","T",88,70,158,142,97,91,188,142,0.484042553191489,0.443037974683544,0.534682080924855,0.0410045785079451
"Chr08","1515718","T","A",95,64,159,160,92,93,185,160,0.502702702702703,0.40251572327044,0.543604651162791,0.100186979432262
"Chr08","1515729","G","T",81,59,140,160,88,74,162,160,0.45679012345679,0.421428571428571,0.559602649006622,0.0353615520282187
"Chr08","1515748","A","G",81,59,140,141,86,71,157,141,0.452229299363057,0.421428571428571,0.562289562289562,0.0308007279344859
"Chr08","1515798","G","C",96,79,175,140,107,88,195,140,0.451282051282051,0.451428571428571,0.548648648648649,-0.000146520146520113
"Chr08","1515805","C","T",96,79,175,138,110,80,190,138,0.421052631578947,0.451428571428571,0.564383561643836,-0.0303759398496241
"Chr08","1515819","T","A",95,81,176,139,106,74,180,139,0.411111111111111,0.460227272727273,0.564606741573034,-0.0491161616161616
"Chr08","1515851","A","G",101,74,175,137,104,72,176,137,0.409090909090909,0.422857142857143,0.584045584045584,-0.0137662337662338
"Chr08","1515900","A","T",100,64,164,146,110,70,180,146,0.388888888888889,0.390243902439024,0.61046511627907,-0.00135501355013551
"Chr08","1515906","C","T",97,59,156,160,112,68,180,160,0.377777777777778,0.378205128205128,0.62202380952381,-0.000427350427350426
"Chr08","1515911","A","T",98,58,156,160,114,64,178,160,0.359550561797753,0.371794871794872,0.634730538922156,-0.012244309997119
"Chr08","1515992","C","A",62,48,110,139,85,52,137,139,0.37956204379562,0.436363636363636,0.595141700404858,-0.0568015925680159
"Chr08","1516036","G","A",59,54,113,160,78,53,131,160,0.404580152671756,0.47787610619469,0.561475409836066,-0.0732959535229346
"Chr08","1516079","A","G",67,37,104,160,71,49,120,160,0.408333333333333,0.355769230769231,0.616071428571429,0.0525641025641025
"Chr08","1516107","T","C",89,34,123,141,82,72,154,141,0.467532467532468,0.276422764227642,0.617328519855596,0.191109703304825
"Chr08","1516165","C","T",89,42,131,136,98,92,190,136,0.484210526315789,0.320610687022901,0.582554517133956,0.163599839292889
"Chr08","1516210","A","T",84,43,127,147,96,93,189,147,0.492063492063492,0.338582677165354,0.569620253164557,0.153480814898138
"Chr08","1516241","C","G",90,51,141,143,94,91,185,143,0.491891891891892,0.361702127659574,0.56441717791411,0.130189764232317
"Chr08","1516285","T","G",67,40,107,160,64,62,126,160,0.492063492063492,0.373831775700935,0.562231759656652,0.118231716362557
"Chr08","1516324","C","T",75,49,124,141,65,70,135,141,0.518518518518518,0.395161290322581,0.540540540540541,0.123357228195938
"Chr08","1516342","A","G",88,58,146,160,79,83,162,160,0.512345679012346,0.397260273972603,0.542207792207792,0.115085405039743
"Chr08","1516357","G","C",84,56,140,160,79,88,167,160,0.526946107784431,0.4,0.530944625407166,0.126946107784431
"Chr08","1516365","A","G",82,52,134,143,81,86,167,143,0.514970059880239,0.388059701492537,0.541528239202658,0.126910358387702
"Chr08","1516417","G","A",65,34,99,151,73,66,139,151,0.474820143884892,0.343434343434343,0.579831932773109,0.131385800450549
"Chr08","1516540","A","G",61,30,91,160,62,57,119,160,0.478991596638655,0.32967032967033,0.585714285714286,0.149321266968326
"Chr08","1516560","C","G",68,33,101,144,71,66,137,144,0.481751824817518,0.326732673267327,0.584033613445378,0.155019151550192
"Chr08","1516580","A","G",65,40,105,144,70,68,138,144,0.492753623188406,0.380952380952381,0.555555555555556,0.111801242236025
"Chr08","1516667","T","C",48,44,92,143,80,88,168,143,0.523809523809524,0.478260869565217,0.492307692307692,0.0455486542443064
"Chr08","1516788","G","A",54,41,95,152,91,75,166,152,0.451807228915663,0.431578947368421,0.555555555555556,0.0202282815472416
"Chr08","1516833","G","C",53,42,95,148,95,59,154,148,0.383116883116883,0.442105263157895,0.594377510040161,-0.0589883800410116
"Chr08","1517028","C","T",48,48,96,160,74,54,128,160,0.421875,0.5,0.544642857142857,-0.078125
"Chr08","1517035","C","T",49,49,98,160,73,59,132,160,0.446969696969697,0.5,0.530434782608696,-0.053030303030303
"Chr08","1517066","A","T",44,34,78,150,82,51,133,150,0.383458646616541,0.435897435897436,0.597156398104265,-0.0524387892808946
"Chr08","1517072","T","G",44,36,80,160,83,49,132,160,0.371212121212121,0.45,0.599056603773585,-0.0787878787878788
"Chr08","1517082","C","T",49,36,85,160,87,48,135,160,0.355555555555556,0.423529411764706,0.618181818181818,-0.0679738562091503
"Chr08","1517786","C","T",9,5,14,123,11,10,21,153,0.476190476190476,0.357142857142857,0.571428571428571,0.119047619047619
"Chr08","1518203","G","C",8,1,9,2,4,5,9,118,0.555555555555556,0.111111111111111,0.666666666666667,0.444444444444444
"Chr08","1520962","C","T",36,71,107,145,46,69,115,145,0.6,0.663551401869159,0.369369369369369,-0.0635514018691589
"Chr08","1521735","A","G",35,63,98,160,46,82,128,160,0.640625,0.642857142857143,0.358407079646018,-0.0022321428571429
"Chr08","1522523","G","A",21,28,49,144,30,31,61,144,0.508196721311475,0.571428571428571,0.463636363636364,-0.063231850117096
"Chr08","1522584","G","A",17,22,39,144,28,32,60,144,0.533333333333333,0.564102564102564,0.454545454545455,-0.0307692307692308
"Chr08","1524037","C","T",65,73,138,140,74,122,196,140,0.622448979591837,0.528985507246377,0.416167664670659,0.0934634723454599
"Chr08","1524079","G","A",75,62,137,149,101,79,180,149,0.438888888888889,0.452554744525547,0.555205047318612,-0.0136658556366586
"Chr08","1530763","G","A",78,39,117,144,56,46,102,144,0.450980392156863,0.333333333333333,0.611872146118721,0.117647058823529
"Chr08","1531029","C","A",93,45,138,143,77,79,156,143,0.506410256410256,0.326086956521739,0.578231292517007,0.180323299888517
"Chr08","1531091","G","T",111,66,177,137,111,95,206,137,0.461165048543689,0.372881355932203,0.579634464751958,0.0882836926114859
"Chr08","1531354","G","C",86,62,148,137,96,91,187,137,0.486631016042781,0.418918918918919,0.543283582089552,0.0677120971238618
"Chr08","1531383","A","T",93,74,167,160,103,102,205,160,0.497560975609756,0.44311377245509,0.526881720430108,0.0544472031546663
"Chr08","1531445","G","A",86,66,152,160,92,104,196,160,0.530612244897959,0.434210526315789,0.511494252873563,0.0964017185821697
"Chr08","1531480","C","T",95,64,159,160,99,115,214,160,0.537383177570093,0.40251572327044,0.520107238605898,0.134867454299653
"Chr08","1531490","G","A",72,97,169,160,124,101,225,160,0.448888888888889,0.57396449704142,0.49746192893401,-0.125075608152531
"Chr08","1532014","A","G",80,60,140,141,103,74,177,141,0.418079096045198,0.428571428571429,0.577287066246057,-0.0104923325262308
"Chr08","1534947","G","A",76,62,138,160,110,84,194,160,0.43298969072165,0.449275362318841,0.560240963855422,-0.0162856715971911
"Chr08","1537631","C","T",65,82,147,160,92,103,195,160,0.528205128205128,0.557823129251701,0.45906432748538,-0.0296180010465724
"Chr08","1537656","C","A",68,81,149,139,88,107,195,139,0.548717948717949,0.543624161073825,0.453488372093023,0.00509378764412327
"Chr08","1537681","C","G",83,64,147,137,110,80,190,137,0.421052631578947,0.435374149659864,0.572700296735905,-0.0143215180809166
"Chr08","1537712","A","G",41,72,113,141,68,90,158,141,0.569620253164557,0.63716814159292,0.402214022140221,-0.0675478884283633
"Chr08","1537843","C","G",30,49,79,160,55,33,88,160,0.375,0.620253164556962,0.508982035928144,-0.245253164556962
"Chr08","1537853","G","C",29,45,74,138,47,30,77,138,0.38961038961039,0.608108108108108,0.503311258278146,-0.218497718497718
"Chr08","1537933","G","C",27,42,69,139,47,32,79,139,0.40506329113924,0.608695652173913,0.5,-0.203632361034673
"Chr08","1537940","G","A",24,40,64,142,44,27,71,142,0.380281690140845,0.625,0.503703703703704,-0.244718309859155
"Chr08","1538095","G","T",16,27,43,160,30,27,57,160,0.473684210526316,0.627906976744186,0.46,-0.15422276621787
"Chr08","1538222","C","T",7,27,34,80,30,27,57,160,0.473684210526316,0.794117647058823,0.406593406593407,-0.320433436532508
"Chr08","1538245","T","A",6,26,32,62,27,27,54,146,0.5,0.8125,0.383720930232558,-0.3125
"Chr08","1538338","C","A",9,21,30,160,16,18,34,160,0.529411764705882,0.7,0.390625,-0.170588235294118
"Chr08","1538364","C","G",7,18,25,142,13,18,31,160,0.580645161290323,0.72,0.357142857142857,-0.139354838709677
"Chr08","1538752","G","A",19,10,29,146,23,24,47,146,0.51063829787234,0.344827586206897,0.552631578947368,0.165810711665444
"Chr08","1538755","G","T",11,19,30,160,24,25,49,160,0.510204081632653,0.633333333333333,0.443037974683544,-0.12312925170068
"Chr08","1538788","G","C",16,24,40,160,24,27,51,160,0.529411764705882,0.6,0.43956043956044,-0.0705882352941176
"Chr08","1538856","C","T",18,25,43,160,27,39,66,160,0.590909090909091,0.581395348837209,0.412844036697248,0.0095137420718816
"Chr08","1540036","A","G",71,62,133,139,102,81,183,139,0.442622950819672,0.466165413533835,0.54746835443038,-0.0235424627141624
"Chr08","1543034","A","G",31,50,81,160,41,44,85,160,0.517647058823529,0.617283950617284,0.433734939759036,-0.0996368917937545
"Chr08","1543248","C","T",32,49,81,146,50,68,118,146,0.576271186440678,0.604938271604938,0.412060301507538,-0.0286670851642603
"Chr08","1543266","C","G",26,49,75,160,47,60,107,160,0.560747663551402,0.653333333333333,0.401098901098901,-0.0925856697819315
"Chr08","1543341","T","C",21,45,66,160,44,55,99,160,0.555555555555556,0.681818181818182,0.393939393939394,-0.126262626262626
"Chr08","1543368","T","G",23,38,61,160,40,51,91,160,0.56043956043956,0.622950819672131,0.414473684210526,-0.0625112592325707
"Chr08","1543417","A","G",33,49,82,160,39,66,105,160,0.628571428571429,0.597560975609756,0.385026737967914,0.0310104529616725
"Chr08","1543426","G","A",34,50,84,141,40,69,109,141,0.63302752293578,0.595238095238095,0.383419689119171,0.0377894276976846
"Chr08","1543466","A","C",31,52,83,160,49,73,122,160,0.598360655737705,0.626506024096386,0.390243902439024,-0.0281453683586806
"Chr08","1543612","C","T",47,65,112,150,51,72,123,150,0.585365853658537,0.580357142857143,0.417021276595745,0.00500871080139365
"Chr08","1543633","A","T",43,55,98,160,47,65,112,160,0.580357142857143,0.561224489795918,0.428571428571429,0.0191326530612246
"Chr08","1543679","A","T",42,60,102,144,43,61,104,144,0.586538461538462,0.588235294117647,0.412621359223301,-0.00169683257918551
"Chr08","1543725","A","G",25,42,67,160,29,46,75,160,0.613333333333333,0.626865671641791,0.380281690140845,-0.0135323383084578
"Chr08","1543748","A","T",37,48,85,160,60,64,124,160,0.516129032258065,0.564705882352941,0.464114832535885,-0.0485768500948767
"Chr08","1543762","C","A",40,52,92,160,58,72,130,160,0.553846153846154,0.565217391304348,0.441441441441441,-0.0113712374581939
"Chr08","1543804","C","T",42,58,100,145,69,79,148,145,0.533783783783784,0.58,0.44758064516129,-0.0462162162162162
"Chr08","1543839","T","C",48,71,119,139,83,89,172,139,0.517441860465116,0.596638655462185,0.450171821305842,-0.0791967949970686
"Chr08","1543854","T","C",49,74,123,141,86,98,184,141,0.532608695652174,0.601626016260163,0.439739413680782,-0.0690173206079887
"Chr08","1543944","G","A",40,76,116,160,75,89,164,160,0.542682926829268,0.655172413793103,0.410714285714286,-0.112489486963835
"Chr08","1544017","G","A",55,101,156,160,103,117,220,160,0.531818181818182,0.647435897435897,0.420212765957447,-0.115617715617716
"Chr08","1544027","C","T",57,104,161,160,97,111,208,160,0.533653846153846,0.645962732919255,0.417344173441734,-0.112308886765409
"Chr08","1544222","T","C",43,88,131,139,71,98,169,139,0.579881656804734,0.67175572519084,0.38,-0.091874068386106
"Chr08","1544236","T","G",47,91,138,160,76,101,177,160,0.570621468926554,0.659420289855073,0.39047619047619,-0.0887988209285189
"Chr08","1544266","C","T",49,87,136,160,80,94,174,160,0.540229885057471,0.639705882352941,0.416129032258065,-0.0994759972954699
"Chr08","1544288","T","A",53,86,139,160,90,91,181,160,0.502762430939227,0.618705035971223,0.446875,-0.115942605031996
"Chr08","1544294","C","T",57,87,144,157,90,91,181,157,0.502762430939227,0.604166666666667,0.452307692307692,-0.10140423572744
"Chr08","1544426","T","C",84,124,208,160,112,124,236,160,0.525423728813559,0.596153846153846,0.441441441441441,-0.0707301173402868
"Chr08","1544478","T","G",63,131,194,160,90,102,192,160,0.53125,0.675257731958763,0.396373056994819,-0.144007731958763
"Chr08","1544498","T","C",66,136,202,160,94,102,196,160,0.520408163265306,0.673267326732673,0.402010050251256,-0.152859163467367
"Chr08","1544508","C","T",66,126,192,160,85,105,190,160,0.552631578947368,0.65625,0.395287958115183,-0.103618421052632
"Chr08","1544627","G","T",65,50,115,160,61,69,130,160,0.530769230769231,0.434782608695652,0.514285714285714,0.0959866220735786
"Chr08","1544692","C","G",59,91,150,136,92,100,192,136,0.520833333333333,0.606666666666667,0.441520467836257,-0.0858333333333333
"Chr08","1544719","G","T",64,90,154,160,99,97,196,160,0.494897959183673,0.584415584415584,0.465714285714286,-0.0895176252319109
"Chr08","1544728","T","A",64,91,155,141,85,98,183,141,0.53551912568306,0.587096774193548,0.440828402366864,-0.0515776485104882
"Chr08","1544789","T","G",78,134,212,160,110,131,241,160,0.54356846473029,0.632075471698113,0.415011037527594,-0.0885070069678228
"Chr08","1544839","T","C",77,125,202,145,112,96,208,145,0.461538461538462,0.618811881188119,0.460975609756098,-0.157273419649657
"Chr08","1544868","G","A",71,130,201,136,92,107,199,136,0.537688442211055,0.646766169154229,0.4075,-0.109077726943174
"Chr08","1544975","T","A",66,105,171,141,90,106,196,141,0.540816326530612,0.614035087719298,0.425068119891008,-0.073218761188686
"Chr08","1544985","A","G",63,101,164,141,88,105,193,141,0.544041450777202,0.615853658536585,0.42296918767507,-0.0718122077593832
"Chr08","1545272","A","G",63,72,135,160,87,88,175,160,0.502857142857143,0.533333333333333,0.483870967741935,-0.0304761904761904
"Chr08","1545282","G","C",73,69,142,160,98,85,183,160,0.46448087431694,0.485915492957746,0.526153846153846,-0.0214346186408066
"Chr08","1545441","T","C",72,87,159,160,81,77,158,160,0.487341772151899,0.547169811320755,0.482649842271293,-0.059828039168856
"Chr08","1545575","A","G",68,101,169,160,97,109,206,160,0.529126213592233,0.597633136094675,0.44,-0.0685069225024416
"Chr08","1545620","G","A",90,124,214,142,119,122,241,142,0.506224066390041,0.579439252336449,0.459340659340659,-0.0732151859464071
"Chr08","1545627","G","T",89,114,203,144,117,120,237,144,0.506329113924051,0.561576354679803,0.468181818181818,-0.0552472407557523
"Chr08","1545664","C","T",68,98,166,136,107,106,213,136,0.497652582159624,0.590361445783133,0.461741424802111,-0.0927088636235081
"Chr08","1545695","G","T",61,93,154,136,112,97,209,136,0.464114832535885,0.603896103896104,0.476584022038567,-0.139781271360219
"Chr08","1545823","A","G",85,90,175,136,109,67,176,136,0.380681818181818,0.514285714285714,0.552706552706553,-0.133603896103896
"Chr08","1545902","T","C",49,107,156,160,83,97,180,160,0.538888888888889,0.685897435897436,0.392857142857143,-0.147008547008547
"Chr08","1546043","G","A",39,94,133,138,71,74,145,138,0.510344827586207,0.706766917293233,0.39568345323741,-0.196422089707026
"Chr08","1546087","T","C",44,102,146,138,82,78,160,138,0.4875,0.698630136986301,0.411764705882353,-0.211130136986301
"Chr08","1546139","A","G",51,86,137,136,75,79,154,136,0.512987012987013,0.627737226277372,0.43298969072165,-0.114750213290359
"Chr08","1546203","G","A",51,91,142,160,95,94,189,160,0.497354497354497,0.640845070422535,0.441087613293051,-0.143490573068038
"Chr08","1546236","C","G",55,80,135,160,91,103,194,160,0.530927835051546,0.592592592592593,0.443768996960486,-0.0616647575410462
"Chr08","1546414","A","G",64,88,152,140,88,90,178,140,0.50561797752809,0.578947368421053,0.460606060606061,-0.0733293908929628
"Chr08","1546502","G","T",52,89,141,138,79,82,161,138,0.509316770186335,0.631205673758865,0.433774834437086,-0.12188890357253
"Chr08","1546509","A","G",55,85,140,142,80,73,153,142,0.477124183006536,0.607142857142857,0.460750853242321,-0.130018674136321
"Chr08","1546534","C","T",51,82,133,139,66,91,157,139,0.579617834394904,0.616541353383459,0.403448275862069,-0.0369235189885542
"Chr08","1546628","C","T",53,53,106,160,58,90,148,160,0.608108108108108,0.5,0.437007874015748,0.108108108108108
"Chr08","1546648","C","T",55,60,115,140,63,98,161,140,0.608695652173913,0.521739130434783,0.427536231884058,0.0869565217391305
"Chr08","1546691","T","C",46,59,105,160,58,82,140,160,0.585714285714286,0.561904761904762,0.424489795918367,0.0238095238095238
"Chr08","1546805","G","C",58,81,139,160,61,100,161,160,0.62111801242236,0.58273381294964,0.396666666666667,0.0383841994727199
"Chr08","1546846","G","A",69,97,166,160,88,137,225,160,0.608888888888889,0.58433734939759,0.40153452685422,0.0245515394912985
"Chr08","1546859","T","G",67,96,163,160,88,138,226,160,0.610619469026549,0.588957055214724,0.398457583547558,0.0216624138118247
"Chr08","1546916","C","T",58,76,134,160,86,106,192,160,0.552083333333333,0.567164179104478,0.441717791411043,-0.0150808457711442
"Chr08","1546937","T","A",59,71,130,137,72,90,162,137,0.555555555555556,0.546153846153846,0.448630136986301,0.00940170940170948
"Chr08","1546964","C","T",57,73,130,160,77,92,169,160,0.544378698224852,0.561538461538462,0.448160535117057,-0.0171597633136095
"Chr08","1546981","A","G",57,59,116,160,62,72,134,160,0.537313432835821,0.508620689655172,0.476,0.0286927431806485
"Chr08","1547011","C","A",55,64,119,160,60,76,136,160,0.558823529411765,0.53781512605042,0.450980392156863,0.0210084033613446
"Chr08","1547043","A","G",48,72,120,141,57,78,135,141,0.577777777777778,0.6,0.411764705882353,-0.0222222222222223
"Chr08","1547068","A","T",46,78,124,141,58,84,142,141,0.591549295774648,0.629032258064516,0.390977443609023,-0.0374829622898682
"Chr08","1547489","C","T",51,83,134,139,63,96,159,139,0.60377358490566,0.619402985074627,0.389078498293515,-0.0156294001689665
"Chr08","1547527","A","T",53,71,124,141,55,87,142,141,0.612676056338028,0.57258064516129,0.406015037593985,0.0400954111767378
"Chr08","1547682","T","C",44,68,112,160,54,65,119,160,0.546218487394958,0.607142857142857,0.424242424242424,-0.0609243697478992
"Chr08","1547749","A","G",39,70,109,160,67,66,133,160,0.496240601503759,0.642201834862385,0.43801652892562,-0.145961233358626
"Chr08","1547904","C","T",42,78,120,160,55,77,132,160,0.583333333333333,0.65,0.384920634920635,-0.0666666666666667
"Chr08","1547911","G","A",43,81,124,145,56,74,130,145,0.569230769230769,0.653225806451613,0.389763779527559,-0.0839950372208437
"Chr08","1547972","G","C",36,67,103,160,51,70,121,160,0.578512396694215,0.650485436893204,0.388392857142857,-0.0719730401989891
"Chr08","1547980","A","C",34,65,99,139,44,57,101,139,0.564356435643564,0.656565656565657,0.39,-0.0922092209220923
"Chr08","1548012","G","A",23,40,63,160,41,46,87,160,0.528735632183908,0.634920634920635,0.426666666666667,-0.106185002736727
"Chr08","1548200","A","G",40,54,94,139,59,48,107,139,0.448598130841121,0.574468085106383,0.492537313432836,-0.125869954265262
"Chr08","1548231","A","G",35,53,88,148,44,52,96,148,0.541666666666667,0.602272727272727,0.429347826086957,-0.0606060606060607
"Chr08","1548241","A","C",34,54,88,160,41,53,94,160,0.563829787234043,0.613636363636364,0.412087912087912,-0.0498065764023211
"Chr08","1548307","C","T",36,41,77,160,40,50,90,160,0.555555555555556,0.532467532467532,0.455089820359281,0.0230880230880232
"Chr08","1548339","T","A",30,39,69,151,34,52,86,151,0.604651162790698,0.565217391304348,0.412903225806452,0.0394337714863499
"Chr08","1548532","A","G",30,28,58,150,25,29,54,150,0.537037037037037,0.482758620689655,0.491071428571429,0.0542784163473819
"Chr08","1548605","A","C",37,30,67,160,34,36,70,160,0.514285714285714,0.447761194029851,0.518248175182482,0.0665245202558635
"Chr08","1548620","C","T",46,39,85,160,40,45,85,160,0.529411764705882,0.458823529411765,0.505882352941176,0.0705882352941177
"Chr08","1548895","C","T",26,35,61,141,29,40,69,141,0.579710144927536,0.573770491803279,0.423076923076923,0.00593965312425759
"Chr08","1548942","G","T",27,41,68,138,37,58,95,138,0.610526315789474,0.602941176470588,0.392638036809816,0.00758513931888549
"Chr08","1548988","T","C",32,35,67,160,33,51,84,160,0.607142857142857,0.522388059701492,0.43046357615894,0.0847547974413646
"Chr08","1549013","A","G",29,39,68,160,31,52,83,160,0.626506024096386,0.573529411764706,0.397350993377483,0.0529766123316797
"Chr08","1549460","C","A",11,12,23,142,10,6,16,108,0.375,0.521739130434783,0.538461538461538,-0.146739130434783
"Chr08","1549852","C","T",47,107,154,136,68,103,171,136,0.60233918128655,0.694805194805195,0.353846153846154,-0.092466013518645
"Chr08","1549909","C","T",73,115,188,136,87,105,192,136,0.546875,0.611702127659574,0.421052631578947,-0.0648271276595744
"Chr08","1549925","C","T",72,113,185,138,81,107,188,138,0.569148936170213,0.610810810810811,0.410187667560322,-0.041661874640598
"Chr08","1549933","T","C",74,107,181,141,85,109,194,141,0.561855670103093,0.591160220994475,0.424,-0.0293045508913824
"Chr08","1549955","A","T",65,109,174,160,74,95,169,160,0.562130177514793,0.626436781609195,0.405247813411079,-0.0643066040944025
"Chr08","1550058","T","C",65,49,114,142,95,57,152,142,0.375,0.429824561403509,0.601503759398496,-0.0548245614035088
"Chr08","1550066","T","G",63,51,114,160,95,63,158,160,0.39873417721519,0.447368421052632,0.580882352941177,-0.0486342438374417
"Chr08","1550080","T","C",61,60,121,136,91,68,159,136,0.427672955974843,0.495867768595041,0.542857142857143,-0.0681948126201986
"Chr08","1550095","G","T",57,61,118,136,93,71,164,136,0.432926829268293,0.516949152542373,0.531914893617021,-0.0840223232740802
"Chr08","1550103","T","A",58,55,113,136,74,94,168,136,0.55952380952381,0.486725663716814,0.469750889679715,0.0727981458069954
"Chr08","1550115","A","G",48,50,98,142,81,66,147,142,0.448979591836735,0.510204081632653,0.526530612244898,-0.0612244897959184
"Chr08","1550179","C","T",39,93,132,160,69,88,157,160,0.560509554140127,0.704545454545455,0.373702422145329,-0.144035900405327
"Chr08","1550200","A","G",45,92,137,160,70,85,155,160,0.548387096774194,0.671532846715328,0.393835616438356,-0.123145749941135
"Chr08","1550224","T","C",44,91,135,137,74,94,168,137,0.55952380952381,0.674074074074074,0.389438943894389,-0.114550264550265
"Chr08","1550236","A","G",49,94,143,138,74,93,167,138,0.55688622754491,0.657342657342657,0.396774193548387,-0.100456429797747
"Chr08","1550281","A","C",59,97,156,136,83,98,181,136,0.541436464088398,0.621794871794872,0.421364985163205,-0.0803584077064741
"Chr08","1550302","A","G",66,97,163,160,79,94,173,160,0.543352601156069,0.595092024539877,0.431547619047619,-0.051739423383808
"Chr08","1550319","A","G",69,103,172,146,84,105,189,146,0.555555555555556,0.598837209302326,0.42382271468144,-0.04328165374677
"Chr08","1550350","A","C",62,97,159,136,72,92,164,136,0.560975609756098,0.610062893081761,0.414860681114551,-0.0490872833256634
"Chr08","1550572","C","A",71,107,178,150,103,90,193,150,0.466321243523316,0.601123595505618,0.46900269541779,-0.134802351982302
"Chr08","1550631","T","G",73,85,158,139,85,84,169,139,0.497041420118343,0.537974683544304,0.483180428134557,-0.0409332634259606
"Chr08","1550680","T","A",71,101,172,137,82,89,171,137,0.52046783625731,0.587209302325581,0.446064139941691,-0.0667414660682715
"Chr08","1550709","G","A",66,118,184,160,90,88,178,160,0.49438202247191,0.641304347826087,0.430939226519337,-0.146922325354177
"Chr08","1550728","A","T",66,106,172,138,86,79,165,138,0.478787878787879,0.616279069767442,0.451038575667656,-0.137491190979563
"Chr08","1550905","C","T",51,79,130,139,67,69,136,139,0.507352941176471,0.607692307692308,0.443609022556391,-0.100339366515837
"Chr08","1550910","A","T",54,78,132,141,64,72,136,141,0.529411764705882,0.590909090909091,0.440298507462687,-0.0614973262032086
"Chr08","1550965","T","C",52,84,136,140,73,64,137,140,0.467153284671533,0.617647058823529,0.457875457875458,-0.150493774151997
"Chr08","1550988","C","T",56,102,158,136,87,80,167,136,0.479041916167665,0.645569620253165,0.44,-0.1665277040855
"Chr08","1551053","C","T",63,87,150,137,89,89,178,137,0.5,0.58,0.463414634146341,-0.08
"Chr08","1551131","T","C",79,95,174,160,104,114,218,160,0.522935779816514,0.545977011494253,0.466836734693878,-0.0230412316777392
"Chr08","1551162","A","T",64,94,158,160,86,112,198,160,0.565656565656566,0.594936708860759,0.421348314606742,-0.0292801432041938
"Chr08","1551188","T","C",59,78,137,140,77,96,173,140,0.554913294797688,0.569343065693431,0.438709677419355,-0.0144297708957428
"Chr08","1551202","T","C",66,84,150,141,80,112,192,141,0.583333333333333,0.56,0.426900584795322,0.0233333333333333
"Chr08","1551276","G","A",63,70,133,160,72,121,193,160,0.626943005181347,0.526315789473684,0.414110429447853,0.100627215707663
"Chr08","1551297","C","G",62,60,122,160,75,107,182,160,0.587912087912088,0.491803278688525,0.450657894736842,0.0961088092235634
"Chr08","1551303","G","C",62,62,124,136,77,107,184,136,0.581521739130435,0.5,0.451298701298701,0.0815217391304348
"Chr08","1551334","G","A",66,70,136,160,72,126,198,160,0.636363636363636,0.514705882352941,0.413173652694611,0.121657754010695
"Chr08","1551343","G","A",65,71,136,160,74,125,199,160,0.628140703517588,0.522058823529412,0.414925373134328,0.106081879988176
"Chr08","1551484","T","C",59,81,140,145,77,103,180,145,0.572222222222222,0.578571428571429,0.425,-0.00634920634920644
"Chr08","1551507","G","A",73,82,155,160,88,101,189,160,0.534391534391534,0.529032258064516,0.468023255813953,0.00535927632701827
"Chr08","1551523","A","G",73,87,160,160,86,104,190,160,0.547368421052632,0.54375,0.454285714285714,0.00361842105263166
"Chr08","1551529","A","G",67,81,148,160,85,99,184,160,0.53804347826087,0.547297297297297,0.457831325301205,-0.00925381903642775
"Chr08","1551575","C","T",57,55,112,160,61,83,144,160,0.576388888888889,0.491071428571429,0.4609375,0.0853174603174603
"Chr08","1551612","G","A",46,61,107,141,61,81,142,141,0.570422535211268,0.570093457943925,0.429718875502008,0.000329077267342437
"Chr08","1551806","T","C",56,69,125,137,91,120,211,137,0.568720379146919,0.552,0.4375,0.0167203791469194
"Chr08","1551822","G","A",58,72,130,140,100,119,219,140,0.54337899543379,0.553846153846154,0.452722063037249,-0.0104671584123639
"Chr08","1551840","C","T",60,64,124,140,104,105,209,140,0.502392344497608,0.516129032258065,0.492492492492492,-0.0137366877604569
"Chr08","1551865","C","T",70,78,148,160,109,111,220,160,0.504545454545455,0.527027027027027,0.486413043478261,-0.0224815724815725
"Chr08","1551884","G","C",76,76,152,160,121,100,221,160,0.452488687782805,0.5,0.528150134048257,-0.0475113122171946
"Chr08","1551892","A","T",83,76,159,160,123,101,224,160,0.450892857142857,0.477987421383648,0.537859007832898,-0.0270945642407907
"Chr08","1551929","C","T",89,90,179,160,128,99,227,160,0.436123348017621,0.502793296089385,0.53448275862069,-0.0666699480717644
"Chr08","1551972","G","A",80,93,173,160,103,97,200,160,0.485,0.53757225433526,0.490616621983914,-0.0525722543352601
"Chr08","1551982","T","C",75,98,173,142,102,98,200,142,0.49,0.566473988439306,0.474530831099196,-0.0764739884393064
"Chr08","1552012","A","T",71,91,162,160,95,93,188,160,0.49468085106383,0.561728395061728,0.474285714285714,-0.0670475439978986
"Chr08","1552049","T","C",51,88,139,139,76,68,144,139,0.472222222222222,0.633093525179856,0.448763250883392,-0.160871302957634
"Chr08","1552069","C","T",49,93,142,139,76,68,144,139,0.472222222222222,0.654929577464789,0.437062937062937,-0.182707355242567
"Chr08","1552307","C","G",110,65,175,160,108,85,193,160,0.440414507772021,0.371428571428571,0.592391304347826,0.0689859363434493
"Chr08","1552350","T","C",50,110,160,138,90,92,182,138,0.505494505494505,0.6875,0.409356725146199,-0.182005494505495
"Chr08","1552359","A","T",52,106,158,139,90,93,183,139,0.508196721311475,0.670886075949367,0.416422287390029,-0.162689354637892
"Chr08","1552381","G","A",53,95,148,138,100,82,182,138,0.450549450549451,0.641891891891892,0.463636363636364,-0.191342441342441
"Chr08","1552389","T","A",62,95,157,137,109,84,193,137,0.435233160621762,0.605095541401274,0.488571428571429,-0.169862380779512
"Chr08","1552411","G","A",72,78,150,140,110,70,180,140,0.388888888888889,0.52,0.551515151515152,-0.131111111111111
"Chr08","1553794","G","C",54,66,120,138,73,80,153,138,0.522875816993464,0.55,0.465201465201465,-0.027124183006536
"Chr08","1554638","C","T",42,49,91,148,52,67,119,148,0.563025210084034,0.538461538461538,0.447619047619048,0.0245636716224952
"Chr08","1554682","G","A",25,39,64,143,32,55,87,143,0.632183908045977,0.609375,0.377483443708609,0.022808908045977
"Chr08","1554690","T","C",36,25,61,144,53,30,83,144,0.36144578313253,0.409836065573771,0.618055555555556,-0.0483902824412404
"Chr08","1554709","G","T",20,29,49,144,26,39,65,144,0.6,0.591836734693878,0.403508771929825,0.00816326530612244
"Chr08","1554750","T","C",17,40,57,142,18,33,51,142,0.647058823529412,0.701754385964912,0.324074074074074,-0.0546955624355004
"Chr08","1554778","C","G",30,66,96,160,44,48,92,160,0.521739130434783,0.6875,0.393617021276596,-0.165760869565217
"Chr08","1554790","G","C",69,34,103,145,57,53,110,145,0.481818181818182,0.330097087378641,0.591549295774648,0.151721094439541
"Chr08","1555590","C","A",50,37,87,145,61,54,115,145,0.469565217391304,0.425287356321839,0.54950495049505,0.0442778610694653
"Chr08","1555679","G","A",45,76,121,139,55,86,141,139,0.609929078014184,0.628099173553719,0.381679389312977,-0.0181700955395346
"Chr08","1556417","C","T",15,10,25,145,14,9,23,144,0.391304347826087,0.4,0.604166666666667,-0.00869565217391305
"Chr08","1556718","C","T",8,13,21,142,23,13,36,142,0.361111111111111,0.619047619047619,0.543859649122807,-0.257936507936508
"Chr08","1557024","C","T",23,14,37,160,24,24,48,160,0.5,0.378378378378378,0.552941176470588,0.121621621621622
"Chr08","1557352","T","C",29,36,65,160,36,46,82,160,0.560975609756098,0.553846153846154,0.442176870748299,0.00712945590994374
"Chr08","1557423","C","T",49,32,81,139,65,48,113,139,0.424778761061947,0.395061728395062,0.587628865979381,0.0297170326668852
"Chr08","1557862","C","T",69,30,99,160,85,77,162,160,0.475308641975309,0.303030303030303,0.590038314176245,0.172278338945006
"Chr08","1558173","G","C",36,50,86,145,79,60,139,145,0.431654676258993,0.581395348837209,0.511111111111111,-0.149740672578217
"Chr08","1558215","G","C",32,55,87,160,87,67,154,160,0.435064935064935,0.632183908045977,0.493775933609959,-0.197118972981042
"Chr08","1558231","T","C",26,52,78,160,67,52,119,160,0.436974789915966,0.666666666666667,0.472081218274112,-0.2296918767507
"Chr08","1558246","T","A",25,51,76,160,66,44,110,160,0.4,0.671052631578947,0.489247311827957,-0.271052631578947
"Chr08","1558310","T","C",17,46,63,160,56,53,109,160,0.486238532110092,0.73015873015873,0.424418604651163,-0.243920198048638
"Chr08","1558434","T","C",32,20,52,156,41,41,82,156,0.5,0.384615384615385,0.544776119402985,0.115384615384615
"Chr08","1558455","G","C",32,25,57,160,43,46,89,160,0.51685393258427,0.43859649122807,0.513698630136986,0.0782574413561996
"Chr08","1558470","C","A",38,41,79,160,58,60,118,160,0.508474576271186,0.518987341772152,0.487309644670051,-0.0105127655009655
"Chr08","1558734","G","C",29,30,59,160,46,45,91,160,0.494505494505495,0.508474576271186,0.5,-0.0139690817656919
"Chr08","1558921","G","T",30,27,57,142,40,37,77,142,0.480519480519481,0.473684210526316,0.522388059701492,0.00683526999316475
"Chr08","1558999","C","G",50,38,88,160,53,51,104,160,0.490384615384615,0.431818181818182,0.536458333333333,0.0585664335664335
"Chr08","1559066","G","A",59,33,92,160,67,53,120,160,0.441666666666667,0.358695652173913,0.594339622641509,0.0829710144927536
"Chr08","1559076","C","T",55,30,85,145,62,46,108,145,0.425925925925926,0.352941176470588,0.606217616580311,0.0729847494553377
"Chr08","1559165","C","T",33,31,64,143,42,45,87,143,0.517241379310345,0.484375,0.496688741721854,0.0328663793103449
"Chr08","1559179","C","T",31,34,65,160,44,49,93,160,0.526881720430108,0.523076923076923,0.474683544303797,0.0038047973531844
"Chr08","1559180","A","C",34,31,65,143,50,43,93,143,0.462365591397849,0.476923076923077,0.531645569620253,-0.0145574855252275
"Chr08","1559188","G","A",34,29,63,140,49,41,90,140,0.455555555555556,0.46031746031746,0.542483660130719,-0.00476190476190474
"Chr08","1559233","C","T",43,28,71,160,51,42,93,160,0.451612903225806,0.394366197183099,0.573170731707317,0.0572467060427079
"Chr08","1559257","C","A",44,27,71,148,52,47,99,148,0.474747474747475,0.380281690140845,0.564705882352941,0.0944657846066297
"Chr08","1559263","A","C",44,29,73,140,53,46,99,140,0.464646464646465,0.397260273972603,0.563953488372093,0.0673861906738619
"Chr08","1559270","T","C",44,32,76,144,51,47,98,144,0.479591836734694,0.421052631578947,0.545977011494253,0.0585392051557465
"Chr08","1559328","A","G",47,22,69,160,44,30,74,160,0.405405405405405,0.318840579710145,0.636363636363636,0.0865648256952605
"Chr08","1559339","T","C",46,22,68,160,39,29,68,160,0.426470588235294,0.323529411764706,0.625,0.102941176470588
"Chr08","1559351","A","G",46,17,63,144,37,21,58,144,0.362068965517241,0.26984126984127,0.685950413223141,0.0922276956759716
"Chr08","1560280","A","C",52,20,72,160,56,38,94,160,0.404255319148936,0.277777777777778,0.650602409638554,0.126477541371158
"Chr08","1560285","C","T",51,22,73,160,58,43,101,160,0.425742574257426,0.301369863013699,0.626436781609195,0.124372711243727
"Chr08","1560304","G","A",51,21,72,160,70,45,115,160,0.391304347826087,0.291666666666667,0.647058823529412,0.0996376811594203
"Chr08","1560368","T","C",39,15,54,142,49,33,82,142,0.402439024390244,0.277777777777778,0.647058823529412,0.124661246612466
"Chr08","1560484","C","G",47,12,59,136,58,33,91,160,0.362637362637363,0.203389830508475,0.7,0.159247532128888
"Chr08","1560602","C","T",46,31,77,160,72,45,117,160,0.384615384615385,0.402597402597403,0.608247422680412,-0.017982017982018
"Chr08","1560677","C","G",66,35,101,139,73,59,132,139,0.446969696969697,0.346534653465347,0.59656652360515,0.10043504350435
"Chr08","1560787","T","C",55,30,85,140,69,57,126,140,0.452380952380952,0.352941176470588,0.587677725118483,0.0994397759103641
"Chr08","1560870","G","A",36,30,66,160,53,44,97,160,0.45360824742268,0.454545454545455,0.54601226993865,-0.00093720712277412
"Chr08","1560895","C","T",42,41,83,160,44,41,85,160,0.482352941176471,0.493975903614458,0.511904761904762,-0.0116229624379872
"Chr08","1561006","A","G",37,23,60,142,45,39,84,142,0.464285714285714,0.383333333333333,0.569444444444444,0.0809523809523809
"Chr08","1561079","G","A",51,30,81,160,63,50,113,160,0.442477876106195,0.37037037037037,0.587628865979381,0.0721075057358244
"Chr08","1561084","G","T",54,29,83,160,56,52,108,160,0.481481481481481,0.349397590361446,0.575916230366492,0.132083891120036
"Chr08","1561091","C","T",57,34,91,141,59,50,109,141,0.458715596330275,0.373626373626374,0.58,0.0850892227039016
"Chr08","1561109","G","A",63,34,97,139,59,50,109,139,0.458715596330275,0.350515463917526,0.592233009708738,0.10820013241275
"Chr08","1561283","A","G",61,31,92,160,67,51,118,160,0.432203389830508,0.33695652173913,0.60952380952381,0.0952468680913781
"Chr08","1561313","G","A",61,33,94,140,58,61,119,140,0.512605042016807,0.351063829787234,0.55868544600939,0.161541212229573
"Chr08","1561412","T","C",55,37,92,160,73,74,147,160,0.503401360544218,0.402173913043478,0.535564853556485,0.101227447500739
"Chr08","1561442","T","C",53,36,89,160,68,75,143,160,0.524475524475524,0.404494382022472,0.521551724137931,0.119981142453053
"Chr08","1561588","A","C",61,47,108,146,69,81,150,146,0.54,0.435185185185185,0.503875968992248,0.104814814814815
"Chr08","1561623","G","A",55,39,94,160,68,75,143,160,0.524475524475524,0.414893617021277,0.518987341772152,0.109581907454248
"Chr08","1561937","C","T",76,61,137,160,84,98,182,160,0.538461538461538,0.445255474452555,0.501567398119122,0.0932060640089837
"Chr08","1562103","A","G",62,66,128,136,96,68,164,136,0.414634146341463,0.515625,0.541095890410959,-0.100990853658537
"Chr08","1562245","A","C",51,47,98,160,44,91,135,160,0.674074074074074,0.479591836734694,0.407725321888412,0.19448223733938
"Chr08","1562394","C","T",59,48,107,160,72,70,142,160,0.492957746478873,0.448598130841121,0.526104417670683,0.0443596156377518
"Chr08","1562404","G","A",76,47,123,160,81,80,161,160,0.496894409937888,0.382113821138211,0.552816901408451,0.114780588799677
"Chr08","1562581","A","G",57,31,88,147,72,54,126,147,0.428571428571429,0.352272727272727,0.602803738317757,0.0762987012987013
"Chr08","1562686","C","A",76,57,133,138,81,102,183,138,0.557377049180328,0.428571428571429,0.496835443037975,0.128805620608899
"Chr08","1562710","A","G",77,60,137,160,69,101,170,160,0.594117647058824,0.437956204379562,0.47557003257329,0.156161442679261
"Chr08","1562802","T","G",73,68,141,160,55,110,165,160,0.666666666666667,0.482269503546099,0.418300653594771,0.184397163120567
"Chr08","1562825","G","A",82,66,148,136,53,110,163,136,0.674846625766871,0.445945945945946,0.434083601286174,0.228900679820925
"Chr08","1563010","G","A",83,36,119,160,81,63,144,160,0.4375,0.302521008403361,0.623574144486692,0.134978991596639
"Chr08","1563051","A","G",81,32,113,139,83,64,147,139,0.435374149659864,0.283185840707965,0.630769230769231,0.152188308951899
"Chr08","1563128","G","T",81,22,103,140,81,64,145,140,0.441379310344828,0.213592233009709,0.653225806451613,0.227787077335119
"Chr08","1563150","T","C",75,18,93,160,78,60,138,160,0.434782608695652,0.193548387096774,0.662337662337662,0.241234221598878
"Chr08","1563213","T","C",69,24,93,143,71,50,121,143,0.413223140495868,0.258064516129032,0.654205607476635,0.155158624366836
"Chr08","1563237","T","C",68,25,93,160,70,49,119,160,0.411764705882353,0.268817204301075,0.650943396226415,0.142947501581278
"Chr08","1563268","A","G",54,22,76,160,56,39,95,160,0.410526315789474,0.289473684210526,0.64327485380117,0.121052631578947
"Chr08","1563277","C","G",55,23,78,160,52,38,90,160,0.422222222222222,0.294871794871795,0.636904761904762,0.127350427350427
"Chr08","1563316","C","G",50,28,78,160,46,48,94,160,0.51063829787234,0.358974358974359,0.558139534883721,0.151663938897981
"Chr08","1563330","A","G",53,26,79,160,50,47,97,160,0.484536082474227,0.329113924050633,0.585227272727273,0.155422158423594
"Chr08","1563348","C","T",47,24,71,141,51,45,96,141,0.46875,0.338028169014085,0.586826347305389,0.130721830985915
"Chr08","1563392","C","A",76,31,107,139,67,67,134,139,0.5,0.289719626168224,0.593360995850622,0.210280373831776
"Chr08","1563424","T","C",71,37,108,139,77,70,147,139,0.476190476190476,0.342592592592593,0.580392156862745,0.133597883597884
"Chr08","1566174","G","T",46,27,73,138,57,64,121,138,0.528925619834711,0.36986301369863,0.530927835051546,0.159062606136081
"Chr08","1566220","G","A",54,27,81,140,70,69,139,140,0.496402877697842,0.333333333333333,0.563636363636364,0.163069544364508
"Chr08","1566379","G","A",71,42,113,160,100,60,160,160,0.375,0.371681415929204,0.626373626373626,0.00331858407079644
"Chr08","1566568","T","G",61,38,99,143,73,75,148,143,0.506756756756757,0.383838383838384,0.54251012145749,0.122918372918373
"Chr08","1566676","A","T",82,55,137,139,76,73,149,139,0.48993288590604,0.401459854014599,0.552447552447552,0.0884730318914417
"Chr08","1566740","T","G",73,46,119,143,74,67,141,143,0.475177304964539,0.38655462184874,0.565384615384615,0.0886226831157995
"Chr08","1567041","C","T",45,16,61,140,45,28,73,140,0.383561643835616,0.262295081967213,0.671641791044776,0.121266561868403
"Chr08","1567080","C","T",41,19,60,160,51,27,78,160,0.346153846153846,0.316666666666667,0.666666666666667,0.0294871794871795
"Chr08","1567098","T","C",41,24,65,160,54,32,86,160,0.372093023255814,0.369230769230769,0.629139072847682,0.0028622540250447
"Chr08","1567118","G","A",47,27,74,142,61,30,91,142,0.32967032967033,0.364864864864865,0.654545454545455,-0.0351945351945352
"Chr08","1567179","T","G",28,25,53,145,44,22,66,145,0.333333333333333,0.471698113207547,0.605042016806723,-0.138364779874214
"Chr08","1567185","G","C",27,28,55,160,44,25,69,160,0.36231884057971,0.509090909090909,0.57258064516129,-0.146772068511199
"Chr08","1567311","A","G",45,42,87,143,71,50,121,143,0.413223140495868,0.482758620689655,0.557692307692308,-0.0695354801937874
"Chr08","1567317","A","G",49,41,90,143,83,50,133,143,0.37593984962406,0.455555555555556,0.591928251121076,-0.0796157059314954
"Chr08","1567328","C","G",49,42,91,141,81,46,127,141,0.362204724409449,0.461538461538462,0.596330275229358,-0.0993337371290127
"Chr08","1567515","T","C",35,42,77,160,66,66,132,160,0.5,0.545454545454545,0.483253588516746,-0.0454545454545454
"Chr08","1567566","G","A",48,43,91,160,51,47,98,160,0.479591836734694,0.472527472527473,0.523809523809524,0.00706436420722134
"Chr08","1567666","C","G",54,42,96,145,64,44,108,145,0.407407407407407,0.4375,0.57843137254902,-0.0300925925925926
"Chr08","1567731","A","G",58,42,100,160,71,64,135,160,0.474074074074074,0.42,0.548936170212766,0.0540740740740741
"Chr08","1567741","C","T",59,46,105,140,71,72,143,140,0.503496503496504,0.438095238095238,0.524193548387097,0.0654012654012655
"Chr08","1567766","G","A",73,43,116,160,77,69,146,160,0.472602739726027,0.370689655172414,0.572519083969466,0.101913084553614
"Chr08","1567789","T","C",72,41,113,139,69,68,137,139,0.496350364963504,0.36283185840708,0.564,0.133518506556424
"Chr08","1567801","A","G",70,40,110,160,67,65,132,160,0.492424242424242,0.363636363636364,0.566115702479339,0.128787878787879
"Chr08","1568071","A","G",39,45,84,136,58,42,100,136,0.42,0.535714285714286,0.527173913043478,-0.115714285714286
"Chr08","1568097","C","T",44,48,92,160,42,62,104,160,0.596153846153846,0.521739130434783,0.438775510204082,0.0744147157190636
"Chr08","1568400","A","G",25,21,46,114,34,27,61,143,0.442622950819672,0.456521739130435,0.551401869158878,-0.0138987883107626
"Chr08","1568549","A","G",36,32,68,140,38,60,98,140,0.612244897959184,0.470588235294118,0.44578313253012,0.141656662665066
"Chr08","1568617","A","G",23,46,69,136,38,70,108,136,0.648148148148148,0.666666666666667,0.344632768361582,-0.0185185185185185
"Chr08","1568726","A","G",52,23,75,137,56,50,106,137,0.471698113207547,0.306666666666667,0.596685082872928,0.165031446540881
"Chr08","1569242","T","C",68,32,100,148,54,48,102,148,0.470588235294118,0.32,0.603960396039604,0.150588235294118
"Chr08","1569267","A","T",54,31,85,160,44,50,94,160,0.531914893617021,0.364705882352941,0.547486033519553,0.16720901126408
"Chr08","1569332","T","C",87,33,120,145,66,53,119,145,0.445378151260504,0.275,0.640167364016736,0.170378151260504
"Chr08","1569621","C","T",80,42,122,160,68,60,128,160,0.46875,0.344262295081967,0.592,0.124487704918033
"Chr08","1569636","C","T",76,39,115,160,63,57,120,160,0.475,0.339130434782609,0.591489361702128,0.135869565217391
"Chr08","1569656","A","G",78,44,122,139,69,58,127,139,0.456692913385827,0.360655737704918,0.590361445783133,0.0960371756809087
"Chr08","1569701","G","A",95,50,145,160,81,52,133,160,0.390977443609023,0.344827586206897,0.633093525179856,0.046149857402126
"Chr08","1569737","C","A",98,62,160,160,102,59,161,160,0.366459627329193,0.3875,0.623052959501558,-0.0210403726708074
"Chr08","1569748","G","T",101,63,164,160,105,57,162,160,0.351851851851852,0.384146341463415,0.631901840490798,-0.0322944896115628
"Chr08","1569756","C","T",98,65,163,146,102,62,164,146,0.378048780487805,0.398773006134969,0.611620795107034,-0.0207242256471644
"Chr08","1569762","C","T",106,70,176,160,103,68,171,160,0.39766081871345,0.397727272727273,0.602305475504323,-6.64540138224368e-05
"Chr08","1569789","C","T",101,71,172,160,111,73,184,160,0.396739130434783,0.412790697674419,0.595505617977528,-0.016051567239636
"Chr08","1569800","A","G",98,62,160,139,109,75,184,139,0.407608695652174,0.3875,0.601744186046512,0.0201086956521739
"Chr08","1569814","G","A",96,64,160,160,100,81,181,160,0.447513812154696,0.4,0.574780058651026,0.0475138121546961
"Chr08","1572497","T","C",85,55,140,160,79,57,136,160,0.419117647058824,0.392857142857143,0.594202898550725,0.0262605042016807
"Chr08","1572522","T","C",82,49,131,160,73,58,131,160,0.442748091603053,0.374045801526718,0.591603053435115,0.0687022900763359
"Chr08","1572566","A","G",71,41,112,160,77,55,132,160,0.416666666666667,0.366071428571429,0.60655737704918,0.0505952380952381
"Chr08","1573318","G","T",45,37,82,139,69,60,129,139,0.465116279069767,0.451219512195122,0.540284360189573,0.0138967668746455
"Chr08","1573323","T","C",38,38,76,160,69,59,128,160,0.4609375,0.5,0.524509803921569,-0.0390625
"Chr08","1573357","C","T",40,39,79,160,64,56,120,160,0.466666666666667,0.493670886075949,0.522613065326633,-0.0270042194092827
"Chr08","1573362","A","T",43,39,82,160,68,54,122,160,0.442622950819672,0.475609756097561,0.544117647058823,-0.0329868052778888
"Chr08","1573368","T","G",43,36,79,160,62,57,119,160,0.478991596638655,0.455696202531646,0.53030303030303,0.0232953941070099
"Chr08","1573450","G","A",23,39,62,151,52,46,98,151,0.469387755102041,0.629032258064516,0.46875,-0.159644502962475
"Chr08","1574621","T","C",52,17,69,143,49,43,92,143,0.467391304347826,0.246376811594203,0.627329192546584,0.221014492753623
"Chr08","1574630","T","C",53,19,72,160,54,48,102,160,0.470588235294118,0.263888888888889,0.614942528735632,0.206699346405229
"Chr08","1574636","C","T",40,22,62,160,42,47,89,160,0.528089887640449,0.354838709677419,0.543046357615894,0.17325117796303
"Chr08","1574671","G","A",43,41,84,160,46,56,102,160,0.549019607843137,0.488095238095238,0.478494623655914,0.0609243697478992
"Chr08","1574690","A","T",41,35,76,146,51,43,94,146,0.457446808510638,0.460526315789474,0.541176470588235,-0.00307950727883538
"Chr08","1574710","T","C",39,42,81,141,42,55,97,141,0.56701030927835,0.518518518518518,0.455056179775281,0.048491790759832
"Chr08","1574747","G","A",39,40,79,140,41,43,84,140,0.511904761904762,0.506329113924051,0.49079754601227,0.0055756479807112
"Chr08","1574827","T","C",27,25,52,160,26,35,61,160,0.573770491803279,0.480769230769231,0.469026548672566,0.0930012610340479
"Chr08","1575944","A","G",115,42,157,160,90,76,166,160,0.457831325301205,0.267515923566879,0.634674922600619,0.190315401734326
"Chr08","1575949","T","C",108,41,149,136,85,77,162,136,0.475308641975309,0.275167785234899,0.620578778135048,0.200140856740409
"Chr08","1575960","A","G",105,41,146,160,85,77,162,160,0.475308641975309,0.280821917808219,0.616883116883117,0.194486724167089
"Chr08","1575965","C","T",102,41,143,160,91,76,167,160,0.455089820359281,0.286713286713287,0.62258064516129,0.168376533645995
"Chr08","1575999","G","T",108,46,154,153,99,84,183,153,0.459016393442623,0.298701298701299,0.614243323442137,0.160315094741324
"Chr08","1576006","T","C",45,104,149,136,77,97,174,136,0.557471264367816,0.697986577181208,0.377708978328173,-0.140515312813392
"Chr08","1576029","A","G",99,42,141,160,89,74,163,160,0.45398773006135,0.297872340425532,0.618421052631579,0.156115389635818
"Chr08","1576054","G","A",84,35,119,143,89,64,153,143,0.418300653594771,0.294117647058824,0.636029411764706,0.124183006535948
"Chr08","1576060","G","A",88,35,123,160,87,62,149,160,0.416107382550336,0.284552845528455,0.643382352941177,0.13155453702188
"Chr08","1576839","G","T",35,22,57,142,33,34,67,142,0.507462686567164,0.385964912280702,0.548387096774194,0.121497774286462
"Chr08","1576866","C","T",30,18,48,147,32,31,63,147,0.492063492063492,0.375,0.558558558558559,0.117063492063492
"Chr08","1576873","G","A",30,17,47,160,32,30,62,160,0.483870967741935,0.361702127659574,0.568807339449541,0.122168840082361
"Chr08","1577094","C","T",26,14,40,142,20,15,35,142,0.428571428571429,0.35,0.613333333333333,0.0785714285714286
"Chr08","1577192","C","T",24,33,57,160,20,33,53,160,0.622641509433962,0.578947368421053,0.4,0.0436941410129096
"Chr08","1577433","A","G",44,25,69,152,30,33,63,152,0.523809523809524,0.36231884057971,0.560606060606061,0.161490683229814
"Chr08","1579127","C","T",49,63,112,160,56,70,126,160,0.555555555555556,0.5625,0.441176470588235,-0.00694444444444442
"Chr08","1579569","T","A",56,58,114,140,49,80,129,140,0.62015503875969,0.508771929824561,0.432098765432099,0.111383108935128
"Chr08","1580699","G","A",47,82,129,143,68,83,151,143,0.549668874172185,0.635658914728682,0.410714285714286,-0.0859900405564967
"Chr08","1581244","A","C",64,87,151,160,87,99,186,160,0.532258064516129,0.576158940397351,0.448071216617211,-0.0439008758812219
"Chr08","1581549","T","C",53,36,89,160,65,57,122,160,0.467213114754098,0.404494382022472,0.559241706161137,0.0627187327316265
"Chr08","1582090","C","T",77,35,112,160,80,62,142,160,0.436619718309859,0.3125,0.618110236220472,0.124119718309859
"Chr08","1582649","G","A",25,22,47,145,27,36,63,145,0.571428571428571,0.468085106382979,0.472727272727273,0.103343465045593
"Chr08","1582887","G","A",40,37,77,160,36,49,85,160,0.576470588235294,0.480519480519481,0.469135802469136,0.0959511077158136
"Chr08","1583995","G","A",104,72,176,160,84,80,164,160,0.48780487804878,0.409090909090909,0.552941176470588,0.0787139689578714
"Chr08","1584021","G","T",113,73,186,160,84,90,174,160,0.517241379310345,0.39247311827957,0.547222222222222,0.124768261030775
"Chr08","1584176","C","T",52,40,92,160,75,40,115,160,0.347826086956522,0.434782608695652,0.613526570048309,-0.0869565217391304
"Chr08","1586622","C","T",51,84,135,138,81,91,172,138,0.529069767441861,0.622222222222222,0.429967426710098,-0.0931524547803617
"Chr08","1588298","T","C",112,96,208,153,140,97,237,153,0.409282700421941,0.461538461538462,0.566292134831461,-0.0522557611165206
"Chr08","1590887","G","C",64,71,135,139,77,80,157,139,0.509554140127389,0.525925925925926,0.482876712328767,-0.0163717857985374
"Chr08","1590899","T","C",63,73,136,140,78,78,156,140,0.5,0.536764705882353,0.482876712328767,-0.0367647058823529
"Chr08","1590948","T","C",53,79,132,141,74,73,147,141,0.496598639455782,0.598484848484849,0.455197132616487,-0.101886209029066
"Chr08","1591393","G","A",77,58,135,151,75,87,162,151,0.537037037037037,0.42962962962963,0.511784511784512,0.107407407407407
"Chr08","1594082","G","A",50,27,77,141,38,47,85,141,0.552941176470588,0.350649350649351,0.54320987654321,0.202291825821238
"Chr08","1594127","G","T",26,36,62,160,36,41,77,160,0.532467532467532,0.580645161290323,0.446043165467626,-0.0481776288227902
"Chr08","1594828","G","A",21,15,36,160,37,37,74,160,0.5,0.416666666666667,0.527272727272727,0.0833333333333333
"Chr08","1594952","A","T",50,27,77,139,44,48,92,139,0.521739130434783,0.350649350649351,0.556213017751479,0.171089779785432
"Chr08","1596093","G","A",53,46,99,160,76,55,131,160,0.419847328244275,0.464646464646465,0.560869565217391,-0.0447991364021899
"Chr08","1596319","T","A",44,64,108,160,81,85,166,160,0.512048192771084,0.592592592592593,0.456204379562044,-0.0805443998215082
"Chr08","1596752","A","G",55,80,135,137,95,93,188,137,0.49468085106383,0.592592592592593,0.464396284829721,-0.0979117415287628
"Chr08","1597268","T","A",89,66,155,160,67,67,134,160,0.5,0.425806451612903,0.539792387543253,0.0741935483870968
"Chr08","1597305","T","C",80,91,171,160,85,84,169,160,0.497041420118343,0.532163742690059,0.485294117647059,-0.0351223225717153
"Chr08","1597500","G","C",61,78,139,160,79,130,209,160,0.62200956937799,0.561151079136691,0.402298850574713,0.0608584902412999
"Chr08","1597914","G","A",99,78,177,160,115,88,203,160,0.433497536945813,0.440677966101695,0.563157894736842,-0.00718042915588207
"Chr08","1598049","G","A",114,64,178,142,102,89,191,142,0.465968586387435,0.359550561797753,0.585365853658537,0.106418024589682
"Chr08","1598233","C","T",89,49,138,160,89,63,152,160,0.414473684210526,0.355072463768116,0.613793103448276,0.0594012204424104
"Chr08","1598246","G","T",86,48,134,160,82,59,141,160,0.418439716312057,0.358208955223881,0.610909090909091,0.0602307610881762
"Chr08","1598299","G","T",79,50,129,160,66,80,146,160,0.547945205479452,0.387596899224806,0.527272727272727,0.160348306254646
"Chr08","1599075","A","G",105,66,171,136,93,94,187,136,0.502673796791444,0.385964912280702,0.553072625698324,0.116708884510742
"Chr08","1600282","G","C",115,75,190,160,107,97,204,160,0.475490196078431,0.394736842105263,0.563451776649746,0.0807533539731682
"Chr08","1600566","A","G",106,146,252,135,130,154,284,135,0.542253521126761,0.579365079365079,0.440298507462687,-0.0371115582383188
"Chr08","1600614","T","C",78,70,148,160,99,83,182,160,0.456043956043956,0.472972972972973,0.536363636363636,-0.0169290169290169
"Chr08","1601262","C","T",85,67,152,146,139,101,240,146,0.420833333333333,0.440789473684211,0.571428571428571,-0.0199561403508772
"Chr08","1601636","G","T",57,71,128,144,75,103,178,144,0.578651685393258,0.5546875,0.431372549019608,0.0239641853932584
"Chr08","1602543","A","T",93,65,158,160,99,117,216,160,0.541666666666667,0.411392405063291,0.513368983957219,0.130274261603375
"Chr08","1603209","C","T",110,66,176,160,110,87,197,160,0.441624365482233,0.375,0.589812332439678,0.0666243654822335
"Chr08","1603428","C","T",71,94,165,160,85,120,205,160,0.585365853658537,0.56969696969697,0.421621621621622,0.0156688839615668
"Chr08","1603997","G","A",74,49,123,160,89,76,165,160,0.460606060606061,0.398373983739837,0.565972222222222,0.0622320768662232
"Chr08","1608182","A","T",54,90,144,160,86,100,186,160,0.537634408602151,0.625,0.424242424242424,-0.0873655913978495
"Chr08","1609328","T","A",68,96,164,160,84,73,157,160,0.464968152866242,0.585365853658537,0.473520249221184,-0.120397700792295
"Chr08","1609943","A","C",61,87,148,142,77,93,170,142,0.547058823529412,0.587837837837838,0.433962264150943,-0.040779014308426
"Chr08","1610232","G","A",99,48,147,137,85,75,160,137,0.46875,0.326530612244898,0.599348534201954,0.142219387755102
"Chr08","1610589","C","T",36,72,108,160,43,60,103,160,0.58252427184466,0.666666666666667,0.374407582938389,-0.0841423948220065
"Chr08","1611100","C","T",13,10,23,160,26,32,58,160,0.551724137931034,0.434782608695652,0.481481481481481,0.116941529235382
"Chr08","1611643","C","T",37,23,60,142,49,40,89,142,0.449438202247191,0.383333333333333,0.577181208053691,0.0661048689138576
"Chr08","1611911","C","T",64,43,107,160,70,67,137,160,0.489051094890511,0.401869158878505,0.549180327868853,0.0871819360120063
"Chr08","1612113","C","G",46,30,76,160,67,64,131,160,0.488549618320611,0.394736842105263,0.545893719806763,0.0938127762153475
"Chr08","1612899","C","T",107,74,181,136,109,88,197,136,0.446700507614213,0.408839779005525,0.571428571428571,0.0378607286086883
"Chr08","1613038","G","T",79,133,212,136,138,115,253,136,0.454545454545455,0.627358490566038,0.466666666666667,-0.172813036020583
"Chr08","1613163","G","A",126,82,208,136,109,109,218,136,0.5,0.394230769230769,0.551643192488263,0.105769230769231
"Chr08","1615374","C","T",27,36,63,160,33,54,87,160,0.620689655172414,0.571428571428571,0.4,0.0492610837438424
"Chr08","1615576","T","C",86,44,130,160,79,63,142,160,0.443661971830986,0.338461538461538,0.606617647058823,0.105200433369447
"Chr08","1615984","C","T",71,44,115,137,108,68,176,137,0.386363636363636,0.382608695652174,0.615120274914089,0.00375494071146243
"Chr08","1616513","G","T",31,17,48,160,44,27,71,160,0.380281690140845,0.354166666666667,0.630252100840336,0.0261150234741784
"Chr08","1616764","T","C",32,45,77,160,46,33,79,160,0.417721518987342,0.584415584415584,0.5,-0.166694065428243
"Chr08","1616782","C","T",41,33,74,144,43,38,81,144,0.469135802469136,0.445945945945946,0.541935483870968,0.0231898565231898
"Chr08","1616834","C","T",51,31,82,145,48,51,99,145,0.515151515151515,0.378048780487805,0.546961325966851,0.13710273466371
"Chr08","1617106","G","C",74,41,115,160,67,46,113,160,0.407079646017699,0.356521739130435,0.618421052631579,0.0505579068872644
"Chr08","1620665","T","C",63,86,149,143,104,99,203,143,0.487684729064039,0.577181208053691,0.474431818181818,-0.0894964789896519
"Chr08","1621300","C","A",86,69,155,141,90,71,161,141,0.440993788819876,0.445161290322581,0.556962025316456,-0.0041675015027049
"Chr08","1622195","C","A",45,41,86,160,66,40,106,160,0.377358490566038,0.476744186046512,0.578125,-0.0993856954804739
"Chr08","1622691","C","G",86,59,145,140,81,74,155,140,0.47741935483871,0.406896551724138,0.556666666666667,0.0705228031145718
"Chr08","1623240","A","G",89,59,148,136,95,76,171,136,0.444444444444444,0.398648648648649,0.576802507836991,0.0457957957957958
"Chr08","1623382","G","A",57,75,132,148,71,99,170,148,0.582352941176471,0.568181818181818,0.423841059602649,0.0141711229946524
"Chr08","1624377","C","G",69,109,178,160,83,106,189,160,0.560846560846561,0.612359550561798,0.4141689373297,-0.051512989715237
"Chr08","1625017","G","A",33,62,95,137,63,71,134,137,0.529850746268657,0.652631578947368,0.419213973799127,-0.122780832678712
"Chr08","1627506","A","G",69,103,172,160,108,109,217,160,0.502304147465438,0.598837209302326,0.455012853470437,-0.0965330618368877
"Chr08","1627769","A","G",68,102,170,160,107,101,208,160,0.485576923076923,0.6,0.462962962962963,-0.114423076923077
"Chr08","1628092","A","T",105,74,179,141,110,132,242,141,0.545454545454545,0.41340782122905,0.510688836104513,0.132046724225495
"Chr08","1628391","G","A",108,77,185,160,100,91,191,160,0.476439790575916,0.416216216216216,0.553191489361702,0.0602235743597
"Chr08","1628402","G","C",118,91,209,160,119,102,221,160,0.461538461538462,0.435406698564593,0.551162790697674,0.0261317629738683
"Chr08","1631207","G","A",20,33,53,140,26,46,72,140,0.638888888888889,0.622641509433962,0.368,0.0162473794549266
"Chr08","1631288","C","T",13,29,42,143,23,22,45,143,0.488888888888889,0.69047619047619,0.413793103448276,-0.201587301587302
"Chr08","1631353","A","G",27,12,39,160,25,34,59,160,0.576271186440678,0.307692307692308,0.530612244897959,0.26857887874837
"Chr08","1631375","G","A",30,21,51,148,26,32,58,148,0.551724137931034,0.411764705882353,0.513761467889908,0.139959432048682
"Chr08","1631725","T","C",45,27,72,140,47,40,87,140,0.459770114942529,0.375,0.578616352201258,0.0847701149425287
"Chr08","1632253","C","A",61,57,118,140,64,81,145,140,0.558620689655172,0.483050847457627,0.475285171102662,0.0755698421975453
"Chr08","1632490","G","A",40,46,86,160,46,64,110,160,0.581818181818182,0.534883720930233,0.438775510204082,0.0469344608879493
"Chr08","1633033","C","A",29,51,80,160,53,40,93,160,0.43010752688172,0.6375,0.473988439306358,-0.20739247311828
"Chr08","1633437","C","T",82,123,205,137,107,89,196,137,0.454081632653061,0.6,0.471321695760599,-0.145918367346939
"Chr08","1633781","G","A",41,77,118,141,80,81,161,141,0.503105590062112,0.652542372881356,0.433691756272401,-0.149436782819244
"Chr08","1634818","G","C",23,41,64,143,44,37,81,143,0.45679012345679,0.640625,0.462068965517241,-0.18383487654321
"Chr08","1634901","G","A",39,51,90,160,50,54,104,160,0.519230769230769,0.566666666666667,0.458762886597938,-0.0474358974358974
"Chr08","1634907","G","A",52,37,89,160,55,49,104,160,0.471153846153846,0.415730337078652,0.55440414507772,0.0554235090751944
"Chr08","1635106","A","G",45,39,84,160,50,62,112,160,0.553571428571429,0.464285714285714,0.48469387755102,0.0892857142857143
"Chr08","1635112","G","A",46,41,87,160,50,60,110,160,0.545454545454545,0.471264367816092,0.487309644670051,0.0741901776384535
"Chr08","1635434","C","T",57,51,108,144,78,59,137,144,0.430656934306569,0.472222222222222,0.551020408163265,-0.0415652879156529
"Chr08","1636179","G","A",29,15,44,160,26,32,58,160,0.551724137931034,0.340909090909091,0.53921568627451,0.210815047021944
"Chr08","1636773","G","T",48,67,115,140,68,69,137,140,0.503649635036496,0.582608695652174,0.46031746031746,-0.0789590606156775
"Chr08","1636835","C","T",47,65,112,160,62,74,136,160,0.544117647058823,0.580357142857143,0.439516129032258,-0.0362394957983194
"Chr08","1637142","C","T",57,54,111,160,72,60,132,160,0.454545454545455,0.486486486486487,0.530864197530864,-0.031941031941032
"Chr08","1638004","C","T",39,38,77,160,53,54,107,160,0.504672897196262,0.493506493506494,0.5,0.0111664036897681
"Chr08","1638059","C","T",22,22,44,140,33,36,69,140,0.521739130434783,0.5,0.486725663716814,0.0217391304347826
"Chr08","1639977","C","T",66,109,175,160,85,94,179,160,0.525139664804469,0.622857142857143,0.426553672316384,-0.0977174780526736
"Chr08","1640012","G","T",64,112,176,142,80,77,157,142,0.490445859872611,0.636363636363636,0.432432432432432,-0.145917776491025
"Chr08","1640080","T","C",54,100,154,144,91,75,166,144,0.451807228915663,0.649350649350649,0.453125,-0.197543420434987
"Chr08","1640154","G","A",78,132,210,160,107,96,203,160,0.472906403940887,0.628571428571429,0.447941888619855,-0.155665024630542
"Chr08","1641146","G","C",55,46,101,160,56,58,114,160,0.508771929824561,0.455445544554455,0.516279069767442,0.053326385270106
"Chr08","1641325","A","T",70,47,117,160,77,64,141,160,0.453900709219858,0.401709401709402,0.569767441860465,0.0521913075104564
"Chr08","1641762","A","G",38,19,57,157,37,38,75,157,0.506666666666667,0.333333333333333,0.568181818181818,0.173333333333333
"Chr08","1642045","G","A",52,28,80,141,65,73,138,141,0.528985507246377,0.35,0.536697247706422,0.178985507246377
"Chr08","1642402","A","T",25,49,74,160,57,70,127,160,0.551181102362205,0.662162162162162,0.407960199004975,-0.110981059799957
"Chr08","1644083","A","G",113,76,189,160,87,93,180,160,0.516666666666667,0.402116402116402,0.5420054200542,0.114550264550265
"Chr08","1644906","G","A",82,63,145,141,83,86,169,141,0.50887573964497,0.43448275862069,0.525477707006369,0.0743929810242808
"Chr08","1645224","T","A",36,31,67,160,51,49,100,160,0.49,0.462686567164179,0.520958083832335,0.0273134328358209
"Chr08","1645411","C","T",24,27,51,160,39,38,77,160,0.493506493506494,0.529411764705882,0.4921875,-0.0359052711993889
"Chr08","1645421","G","A",24,26,50,148,34,33,67,148,0.492537313432836,0.52,0.495726495726496,-0.0274626865671642
"Chr08","1645433","G","T",27,25,52,160,35,35,70,160,0.5,0.480769230769231,0.508196721311475,0.0192307692307692
"Chr08","1646024","G","T",56,73,129,160,80,87,167,160,0.520958083832335,0.565891472868217,0.459459459459459,-0.0449333890358817
"Chr08","1646032","T","C",60,82,142,160,80,91,171,160,0.532163742690059,0.577464788732394,0.447284345047923,-0.0453010460423359
"Chr08","1646238","G","A",62,80,142,160,88,120,208,160,0.576923076923077,0.563380281690141,0.428571428571429,0.013542795232936
"Chr08","1646766","C","T",36,18,54,153,58,62,120,153,0.516666666666667,0.333333333333333,0.540229885057471,0.183333333333333
"Chr08","1646851","C","T",24,45,69,145,58,70,128,145,0.546875,0.652173913043478,0.416243654822335,-0.105298913043478
"Chr08","1646909","G","A",27,51,78,160,54,52,106,160,0.490566037735849,0.653846153846154,0.440217391304348,-0.163280116110305
"Chr08","1648260","C","G",88,69,157,136,104,87,191,136,0.455497382198953,0.439490445859873,0.551724137931034,0.0160069363390802
"Chr08","1648500","T","C",47,76,123,142,71,78,149,142,0.523489932885906,0.617886178861789,0.433823529411765,-0.0943962459758826
"Chr08","1648800","G","A",50,30,80,144,50,50,100,144,0.5,0.375,0.555555555555556,0.125
"Chr08","1648965","T","A",27,34,61,160,30,23,53,160,0.433962264150943,0.557377049180328,0.5,-0.123414785029384
"Chr08","1649633","G","A",83,108,191,160,76,106,182,160,0.582417582417582,0.565445026178011,0.42627345844504,0.0169725562395719
"Chr08","1649878","C","T",97,64,161,160,96,84,180,160,0.466666666666667,0.397515527950311,0.565982404692082,0.0691511387163561
"Chr08","1649970","G","A",78,111,189,137,84,105,189,137,0.555555555555556,0.587301587301587,0.428571428571429,-0.0317460317460317
"Chr08","1650262","G","T",38,59,97,144,55,33,88,144,0.375,0.608247422680412,0.502702702702703,-0.233247422680412
"Chr08","1650384","A","G",46,45,91,139,39,62,101,139,0.613861386138614,0.494505494505495,0.442708333333333,0.119355891633119
"Chr08","1650529","G","A",67,86,153,148,73,77,150,148,0.513333333333333,0.562091503267974,0.462046204620462,-0.0487581699346405
"Chr08","1651387","G","A",30,18,48,145,21,25,46,145,0.543478260869565,0.375,0.542553191489362,0.168478260869565
"Chr08","1652132","G","A",56,70,126,142,86,77,163,142,0.47239263803681,0.555555555555556,0.491349480968858,-0.0831629175187458
"Chr08","1652364","T","G",53,57,110,160,77,64,141,160,0.453900709219858,0.518181818181818,0.51792828685259,-0.06428110896196
"Chr08","1652611","T","C",105,112,217,160,139,116,255,160,0.454901960784314,0.516129032258065,0.516949152542373,-0.0612270714737508
"Chr08","1652877","G","A",84,68,152,160,73,98,171,160,0.573099415204678,0.447368421052632,0.486068111455108,0.125730994152047
"Chr08","1653143","A","T",114,82,196,160,115,112,227,160,0.493392070484582,0.418367346938776,0.541371158392435,0.075024723545806
"Chr08","1653566","T","G",118,87,205,141,115,87,202,141,0.430693069306931,0.424390243902439,0.572481572481572,0.00630282540449167
"Chr08","1653641","C","T",72,95,167,138,98,107,205,138,0.521951219512195,0.568862275449102,0.456989247311828,-0.0469110559369067
"Chr08","1654132","C","T",46,35,81,160,37,36,73,160,0.493150684931507,0.432098765432099,0.538961038961039,0.0610519194994081
"Chr08","1654213","A","G",30,38,68,147,43,30,73,147,0.410958904109589,0.558823529411765,0.517730496453901,-0.147864625302176
"Chr08","1656406","A","G",103,68,171,142,100,92,192,142,0.479166666666667,0.39766081871345,0.559228650137741,0.0815058479532164
"Chr08","1656768","C","T",124,66,190,160,105,85,190,160,0.447368421052632,0.347368421052632,0.602631578947368,0.1
"Chr08","1657597","G","T",104,140,244,160,111,139,250,160,0.556,0.573770491803279,0.435222672064777,-0.0177704918032786
"Chr08","1657703","G","A",145,111,256,160,135,136,271,160,0.501845018450184,0.43359375,0.531309297912713,0.0682512684501845
"Chr08","1658079","A","C",92,55,147,160,59,88,147,160,0.598639455782313,0.374149659863946,0.513605442176871,0.224489795918367
"Chr08","1663566","T","C",60,68,128,160,50,66,116,160,0.568965517241379,0.53125,0.450819672131148,0.0377155172413793
"Chr08","1670801","C","T",46,95,141,136,75,103,178,136,0.578651685393258,0.673758865248227,0.379310344827586,-0.0951071798549685
"Chr08","1672439","T","A",74,111,185,136,122,122,244,136,0.5,0.6,0.456876456876457,-0.1
"Chr08","1673296","C","T",62,100,162,143,67,78,145,143,0.537931034482759,0.617283950617284,0.420195439739414,-0.0793529161345253
"Chr08","1674074","A","G",14,43,57,160,29,31,60,160,0.516666666666667,0.754385964912281,0.367521367521368,-0.237719298245614
"Chr08","1680146","A","G",59,36,95,139,65,55,120,139,0.458333333333333,0.378947368421053,0.576744186046512,0.0793859649122807
"Chr08","1702894","A","G",70,85,155,160,78,98,176,160,0.556818181818182,0.548387096774194,0.447129909365559,0.00843108504398826
"Chr08","1703086","A","G",51,37,88,160,47,32,79,160,0.40506329113924,0.420454545454545,0.586826347305389,-0.015391254315305
"Chr08","1703607","A","G",21,21,42,142,16,26,42,142,0.619047619047619,0.5,0.44047619047619,0.119047619047619
"Chr08","1703633","C","G",30,20,50,160,21,30,51,160,0.588235294117647,0.4,0.504950495049505,0.188235294117647
"Chr08","1705830","G","A",45,31,76,160,49,52,101,160,0.514851485148515,0.407894736842105,0.531073446327684,0.10695674830641
"Chr08","1706009","A","G",63,41,104,160,61,64,125,160,0.512,0.394230769230769,0.541484716157205,0.117769230769231
"Chr08","1706274","C","T",28,26,54,143,41,39,80,143,0.4875,0.481481481481481,0.514925373134328,0.00601851851851853
"Chr08","1706504","C","T",63,50,113,150,80,77,157,150,0.490445859872611,0.442477876106195,0.52962962962963,0.0479679837664168
"Chr08","1706560","A","T",57,48,105,160,86,76,162,160,0.469135802469136,0.457142857142857,0.535580524344569,0.0119929453262786
"Chr08","1706565","G","A",58,48,106,160,86,78,164,160,0.475609756097561,0.452830188679245,0.533333333333333,0.0227795674183157
"Chr08","1706615","G","A",59,51,110,160,71,81,152,160,0.532894736842105,0.463636363636364,0.49618320610687,0.0692583732057417
"Chr08","1706672","G","A",49,47,96,139,64,68,132,139,0.515151515151515,0.489583333333333,0.495614035087719,0.0255681818181818
"Chr08","1706849","C","G",53,42,95,145,70,61,131,145,0.465648854961832,0.442105263157895,0.544247787610619,0.0235435918039373
"Chr08","1707191","C","A",49,29,78,151,80,57,137,151,0.416058394160584,0.371794871794872,0.6,0.0442635223657121
"Chr08","1707241","C","T",39,18,57,160,68,62,130,160,0.476923076923077,0.315789473684211,0.572192513368984,0.161133603238866
"Chr08","1707299","T","C",45,20,65,140,62,58,120,140,0.483333333333333,0.307692307692308,0.578378378378378,0.175641025641026
"Chr08","1707324","G","A",49,28,77,142,65,65,130,142,0.5,0.363636363636364,0.550724637681159,0.136363636363636
"Chr08","1707357","T","C",38,25,63,142,59,41,100,142,0.41,0.396825396825397,0.595092024539877,0.0131746031746032
"Chr08","1707523","C","T",54,31,85,160,74,53,127,160,0.417322834645669,0.364705882352941,0.60377358490566,0.0526169522927281
"Chr08","1707528","C","T",57,32,89,142,78,53,131,142,0.404580152671756,0.359550561797753,0.613636363636364,0.0450295908740029
"Chr08","1707583","C","A",46,35,81,160,84,44,128,160,0.34375,0.432098765432099,0.62200956937799,-0.0883487654320987
"Chr08","1708135","A","G",39,34,73,148,43,49,92,148,0.532608695652174,0.465753424657534,0.496969696969697,0.0668552709946397
"Chr08","1708294","A","G",73,45,118,137,84,84,168,137,0.5,0.38135593220339,0.548951048951049,0.11864406779661
"Chr08","1708324","C","T",74,42,116,160,85,69,154,160,0.448051948051948,0.362068965517241,0.588888888888889,0.0859829825347067
"Chr08","1708438","A","T",96,52,148,160,74,68,142,160,0.47887323943662,0.351351351351351,0.586206896551724,0.127521888085268
"Chr08","1709042","G","A",67,57,124,143,63,74,137,143,0.54014598540146,0.459677419354839,0.498084291187739,0.0804685660466212
"Chr08","1710206","A","T",88,56,144,160,110,79,189,160,0.417989417989418,0.388888888888889,0.594594594594595,0.0291005291005291
"Chr08","1712813","G","A",53,41,94,160,60,76,136,160,0.558823529411765,0.436170212765957,0.491304347826087,0.122653316645807
"Chr08","1714425","T","G",48,35,83,160,62,43,105,160,0.40952380952381,0.421686746987952,0.585106382978723,-0.0121629374641423
"Chr08","1714597","G","A",66,36,102,160,77,82,159,160,0.515723270440252,0.352941176470588,0.547892720306513,0.162782093969663
"Chr08","1714930","A","G",46,45,91,160,64,49,113,160,0.433628318584071,0.494505494505495,0.53921568627451,-0.0608771759214237
"Chr08","1715103","C","T",52,42,94,144,63,49,112,144,0.4375,0.446808510638298,0.558252427184466,-0.00930851063829785
"Chr08","1715598","C","T",35,19,54,160,30,29,59,160,0.491525423728814,0.351851851851852,0.575221238938053,0.139673571876962
"Chr08","1716385","T","C",60,48,108,160,54,65,119,160,0.546218487394958,0.444444444444444,0.502202643171806,0.101774042950514
"Chr08","1716520","A","C",44,41,85,144,43,63,106,144,0.594339622641509,0.482352941176471,0.455497382198953,0.111986681465039
"Chr08","1716668","G","A",26,33,59,160,49,45,94,160,0.478723404255319,0.559322033898305,0.490196078431373,-0.0805986296429859
"Chr08","1716679","G","T",32,33,65,139,46,46,92,139,0.5,0.507692307692308,0.496815286624204,-0.00769230769230766
"Chr08","1716694","C","A",27,31,58,139,43,41,84,139,0.488095238095238,0.53448275862069,0.492957746478873,-0.0463875205254515
"Chr08","1716749","T","C",31,31,62,160,43,38,81,160,0.469135802469136,0.5,0.517482517482518,-0.0308641975308642
"Chr08","1716953","G","A",30,24,54,148,47,40,87,148,0.459770114942529,0.444444444444444,0.546099290780142,0.0153256704980843
"Chr08","1717861","T","C",25,27,52,160,17,24,41,160,0.585365853658537,0.519230769230769,0.451612903225806,0.0661350844277673
"Chr08","1718545","T","C",44,37,81,149,41,32,73,149,0.438356164383562,0.45679012345679,0.551948051948052,-0.0184339590732285
"Chr08","1719004","A","G",30,16,46,160,18,27,45,160,0.6,0.347826086956522,0.527472527472527,0.252173913043478
"Chr08","1720272","G","A",62,42,104,160,56,42,98,160,0.428571428571429,0.403846153846154,0.584158415841584,0.0247252747252747
"Chr08","1720365","A","G",46,38,84,140,38,36,74,140,0.486486486486487,0.452380952380952,0.531645569620253,0.0341055341055341
"Chr08","1720670","C","A",49,43,92,160,56,44,100,160,0.44,0.467391304347826,0.546875,-0.0273913043478261
"Chr08","1720966","G","C",39,26,65,160,37,43,80,160,0.5375,0.4,0.524137931034483,0.1375
"Chr08","1721017","G","T",43,27,70,143,42,45,87,143,0.517241379310345,0.385714285714286,0.54140127388535,0.131527093596059
"Chr08","1721096","G","A",47,23,70,160,43,46,89,160,0.51685393258427,0.328571428571429,0.566037735849057,0.188282504012841
"Chr08","1721242","C","T",44,27,71,140,45,52,97,140,0.536082474226804,0.380281690140845,0.529761904761905,0.155800784085959
"Chr08","1721330","G","A",32,23,55,160,49,48,97,160,0.494845360824742,0.418181818181818,0.532894736842105,0.0766635426429241
"Chr08","1721356","A","G",39,24,63,160,56,35,91,160,0.384615384615385,0.380952380952381,0.616883116883117,0.00366300366300371
"Chr08","1722660","A","G",50,22,72,142,50,55,105,142,0.523809523809524,0.305555555555556,0.564971751412429,0.218253968253968
"Chr08","1724328","G","A",37,28,65,160,39,38,77,160,0.493506493506494,0.430769230769231,0.535211267605634,0.0627372627372627
"Chr08","1724349","A","T",34,27,61,160,36,35,71,160,0.492957746478873,0.442622950819672,0.53030303030303,0.0503347956592011
"Chr08","1724417","A","G",30,24,54,145,30,38,68,145,0.558823529411765,0.444444444444444,0.491803278688525,0.11437908496732
"Chr08","1724461","G","A",29,24,53,143,28,45,73,143,0.616438356164384,0.452830188679245,0.452380952380952,0.163608167485138
"Chr08","1724659","C","T",33,23,56,160,35,35,70,160,0.5,0.410714285714286,0.53968253968254,0.0892857142857143
"Chr08","1724991","A","G",38,19,57,160,36,45,81,160,0.555555555555556,0.333333333333333,0.536231884057971,0.222222222222222
"Chr08","1725000","T","C",36,19,55,160,37,45,82,160,0.548780487804878,0.345454545454545,0.532846715328467,0.203325942350333
"Chr08","1725637","A","G",40,22,62,145,24,51,75,145,0.68,0.354838709677419,0.467153284671533,0.325161290322581
"Chr08","1725695","A","G",35,22,57,160,24,48,72,160,0.666666666666667,0.385964912280702,0.457364341085271,0.280701754385965
"Chr08","1725719","C","T",25,14,39,160,19,39,58,160,0.672413793103448,0.358974358974359,0.45360824742268,0.313439434129089
"Chr08","1725785","G","A",27,19,46,160,18,20,38,160,0.526315789473684,0.41304347826087,0.535714285714286,0.113272311212815
"Chr08","1726027","T","A",24,11,35,160,9,19,28,160,0.678571428571429,0.314285714285714,0.523809523809524,0.364285714285714
"Chr08","1726046","C","T",24,13,37,148,12,18,30,148,0.6,0.351351351351351,0.537313432835821,0.248648648648649
"Chr08","1726338","C","T",28,15,43,160,21,16,37,160,0.432432432432432,0.348837209302326,0.6125,0.0835952231301069
"Chr08","1727150","G","C",28,13,41,160,35,25,60,160,0.416666666666667,0.317073170731707,0.623762376237624,0.0995934959349594
"Chr08","1727204","T","G",35,13,48,160,32,28,60,160,0.466666666666667,0.270833333333333,0.62037037037037,0.195833333333333
"Chr08","1729085","G","A",93,63,156,160,79,73,152,160,0.480263157894737,0.403846153846154,0.558441558441558,0.076417004048583
"Chr08","1730044","T","A",92,58,150,137,115,85,200,137,0.425,0.386666666666667,0.591428571428571,0.0383333333333333
"Chr08","1730119","G","A",77,55,132,155,92,72,164,155,0.439024390243902,0.416666666666667,0.570945945945946,0.0223577235772358
"Chr08","1730200","C","T",62,36,98,151,50,60,110,151,0.545454545454545,0.36734693877551,0.538461538461538,0.178107606679035
"Chr08","1730260","A","G",86,39,125,160,85,88,173,160,0.508670520231214,0.312,0.573825503355705,0.196670520231214
"Chr08","1730502","A","G",58,38,96,160,76,53,129,160,0.410852713178295,0.395833333333333,0.595555555555556,0.0150193798449613
"Chr08","1730976","G","A",45,42,87,141,54,41,95,141,0.431578947368421,0.482758620689655,0.543956043956044,-0.0511796733212341
"Chr08","1731027","G","A",42,39,81,160,47,31,78,160,0.397435897435897,0.481481481481481,0.559748427672956,-0.084045584045584
"Chr08","1731266","G","T",60,39,99,160,69,52,121,160,0.429752066115702,0.393939393939394,0.586363636363636,0.0358126721763086
"Chr08","1731440","G","A",55,49,104,160,63,63,126,160,0.5,0.471153846153846,0.51304347826087,0.0288461538461539
"Chr08","1731446","A","T",55,45,100,160,56,63,119,160,0.529411764705882,0.45,0.506849315068493,0.0794117647058823
"Chr08","1733122","A","G",100,75,175,160,102,90,192,160,0.46875,0.428571428571429,0.550408719346049,0.0401785714285715
"Chr08","1733415","C","T",137,58,195,160,127,81,208,160,0.389423076923077,0.297435897435897,0.655086848635236,0.0919871794871795
"Chr08","1733957","C","T",42,74,116,160,43,68,111,160,0.612612612612613,0.637931034482759,0.374449339207048,-0.0253184218701461
"Chr08","1736115","A","G",39,31,70,160,35,39,74,160,0.527027027027027,0.442857142857143,0.513888888888889,0.0841698841698841
"Chr08","1736822","T","C",25,23,48,160,44,44,88,160,0.5,0.479166666666667,0.507352941176471,0.0208333333333333
"Chr08","1736914","T","C",35,28,63,140,50,43,93,140,0.462365591397849,0.444444444444444,0.544871794871795,0.017921146953405
"Chr08","1737235","T","A",29,20,49,142,33,18,51,142,0.352941176470588,0.408163265306122,0.62,-0.0552220888355342
"Chr08","1737937","T","C",25,13,38,149,36,23,59,149,0.389830508474576,0.342105263157895,0.628865979381443,0.0477252453166815
"Chr08","1739025","G","C",38,33,71,160,51,44,95,160,0.463157894736842,0.464788732394366,0.536144578313253,-0.00163083765752409
"Chr08","1740426","A","G",108,28,136,139,98,57,155,139,0.367741935483871,0.205882352941176,0.707903780068729,0.161859582542695
"Chr08","1740663","G","A",80,56,136,160,91,86,177,160,0.485875706214689,0.411764705882353,0.546325878594249,0.0741110003323364
"Chr08","1740702","A","G",72,52,124,143,76,93,169,143,0.550295857988166,0.419354838709677,0.505119453924915,0.130941019278488
"Chr08","1740733","C","T",92,48,140,157,96,91,187,157,0.486631016042781,0.342857142857143,0.574923547400612,0.143773873185638
"Chr08","1741044","T","C",66,58,124,140,89,67,156,140,0.429487179487179,0.467741935483871,0.553571428571429,-0.0382547559966915
"Chr08","1741089","G","A",70,67,137,160,99,94,193,160,0.487046632124352,0.489051094890511,0.512121212121212,-0.00200446276615862
"Chr08","1741167","G","A",63,53,116,143,82,82,164,143,0.5,0.456896551724138,0.517857142857143,0.043103448275862
"Chr08","1741424","A","G",93,57,150,149,102,89,191,149,0.465968586387435,0.38,0.571847507331378,0.0859685863874345
"Chr08","1742429","C","T",40,12,52,139,43,53,96,139,0.552083333333333,0.230769230769231,0.560810810810811,0.321314102564103
"Chr08","1744221","T","C",10,6,16,142,14,12,26,160,0.461538461538462,0.375,0.571428571428571,0.0865384615384616
"Chr08","1745182","C","T",52,36,88,160,52,50,102,160,0.490196078431373,0.409090909090909,0.547368421052632,0.0811051693404634
"Chr08","1746382","C","G",77,53,130,146,71,68,139,146,0.489208633093525,0.407692307692308,0.550185873605948,0.0815163254012175
"Chr08","1746421","A","T",66,57,123,160,72,82,154,160,0.532467532467532,0.463414634146341,0.498194945848375,0.0690528983211909
"Chr08","1746813","A","G",81,68,149,137,102,103,205,137,0.502439024390244,0.456375838926175,0.516949152542373,0.0460631854640694
"Chr08","1746934","A","T",92,47,139,160,110,100,210,160,0.476190476190476,0.338129496402878,0.578796561604584,0.138060979787598
"Chr08","1747017","T","C",107,62,169,160,120,117,237,160,0.493670886075949,0.366863905325444,0.559113300492611,0.126806980750506
"Chr08","1747410","A","G",70,49,119,160,62,71,133,160,0.533834586466165,0.411764705882353,0.523809523809524,0.122069880583813
"Chr08","1747826","G","T",80,51,131,160,97,55,152,160,0.361842105263158,0.389312977099237,0.625441696113074,-0.0274708718360787
"Chr08","1751417","A","G",92,57,149,160,89,80,169,160,0.473372781065089,0.38255033557047,0.569182389937107,0.0908224454946189
"Chr08","1755096","G","A",47,42,89,160,60,49,109,160,0.44954128440367,0.471910112359551,0.54040404040404,-0.0223688279558808
"Chr08","1755431","G","A",77,46,123,145,98,71,169,145,0.420118343195266,0.373983739837398,0.599315068493151,0.0461346033578679
"Chr08","1755828","T","G",70,65,135,160,101,68,169,160,0.402366863905325,0.481481481481481,0.5625,-0.079114617576156
"Chr08","1756771","C","G",50,29,79,141,33,47,80,141,0.5875,0.367088607594937,0.522012578616352,0.220411392405063
"Chr08","1757115","A","G",26,32,58,142,38,40,78,142,0.512820512820513,0.551724137931034,0.470588235294118,-0.0389036251105217
"Chr08","1757259","T","A",32,23,55,144,24,43,67,144,0.641791044776119,0.418181818181818,0.459016393442623,0.223609226594301
"Chr08","1757464","T","A",37,42,79,140,51,32,83,140,0.385542168674699,0.531645569620253,0.54320987654321,-0.146103400945554
"Chr08","1757554","G","C",41,49,90,146,62,49,111,146,0.441441441441441,0.544444444444444,0.512437810945274,-0.103003003003003
"Chr08","1757788","A","G",60,51,111,143,70,52,122,143,0.426229508196721,0.459459459459459,0.55793991416309,-0.0332299512627382
"Chr08","1757831","G","T",66,54,120,160,73,57,130,160,0.438461538461538,0.45,0.556,-0.0115384615384616
"Chr08","1758637","A","C",127,84,211,136,132,91,223,136,0.408071748878924,0.398104265402844,0.596774193548387,0.00996748347608017
"Chr08","1759936","C","G",97,73,170,141,97,110,207,141,0.531400966183575,0.429411764705882,0.514588859416446,0.101989201477693
"Chr08","1760239","C","T",86,66,152,160,84,102,186,160,0.548387096774194,0.434210526315789,0.502958579881657,0.114176570458404
"Chr08","1760902","G","A",33,26,59,160,25,29,54,160,0.537037037037037,0.440677966101695,0.513274336283186,0.0963590709353422
"Chr08","1762714","T","C",23,26,49,160,25,21,46,160,0.456521739130435,0.530612244897959,0.505263157894737,-0.0740905057675245
"Chr08","1763470","A","G",43,38,81,136,79,83,162,136,0.512345679012346,0.469135802469136,0.502057613168724,0.04320987654321
"Chr08","1763513","T","C",89,68,157,141,120,121,241,141,0.50207468879668,0.43312101910828,0.525125628140704,0.0689536696884002
"Chr08","1763748","G","A",64,47,111,160,94,76,170,160,0.447058823529412,0.423423423423423,0.562277580071174,0.0236354001059884
"Chr08","1764568","C","G",29,28,57,151,39,55,94,151,0.585106382978723,0.491228070175439,0.450331125827815,0.0938783128032848
"Chr08","1765172","A","G",81,72,153,160,78,95,173,160,0.549132947976879,0.470588235294118,0.487730061349693,0.078544712682761
"Chr08","1765194","T","C",72,62,134,142,78,77,155,142,0.496774193548387,0.462686567164179,0.519031141868512,0.034087626384208
"Chr08","1766070","C","T",49,38,87,155,55,46,101,155,0.455445544554455,0.436781609195402,0.553191489361702,0.0186639353590531
"Chr08","1766378","C","T",61,48,109,160,72,49,121,160,0.40495867768595,0.440366972477064,0.578260869565217,-0.0354082947911138
"Chr08","1766821","T","C",68,48,116,160,76,73,149,160,0.48993288590604,0.413793103448276,0.543396226415094,0.0761397824577644
"Chr08","1767319","A","C",74,51,125,160,100,82,182,160,0.450549450549451,0.408,0.566775244299674,0.0425494505494506
"Chr08","1769229","G","A",54,36,90,160,66,57,123,160,0.463414634146341,0.4,0.563380281690141,0.0634146341463415
"Chr08","1770409","T","C",51,36,87,147,50,78,128,147,0.609375,0.413793103448276,0.469767441860465,0.195581896551724
"Chr08","1770660","A","G",45,29,74,141,49,47,96,141,0.489583333333333,0.391891891891892,0.552941176470588,0.0976914414414414
"Chr08","1770741","C","G",66,54,120,139,69,76,145,139,0.524137931034483,0.45,0.509433962264151,0.0741379310344828
"Chr08","1771169","G","A",22,14,36,160,30,29,59,160,0.491525423728814,0.388888888888889,0.547368421052632,0.102636534839925
"Chr08","1771515","G","C",24,12,36,160,14,16,30,160,0.533333333333333,0.333333333333333,0.575757575757576,0.2
"Chr08","1771817","C","T",28,20,48,160,21,33,54,160,0.611111111111111,0.416666666666667,0.480392156862745,0.194444444444444
"Chr08","1773234","T","G",82,53,135,160,89,93,182,160,0.510989010989011,0.392592592592593,0.539432176656151,0.118396418396418
"Chr08","1774611","T","G",24,35,59,139,24,37,61,139,0.60655737704918,0.593220338983051,0.4,0.0133370380661295
"Chr08","1787200","C","A",28,19,47,160,29,22,51,160,0.431372549019608,0.404255319148936,0.581632653061224,0.0271172298706717
"Chr08","1788685","A","T",46,26,72,145,36,39,75,145,0.52,0.361111111111111,0.557823129251701,0.158888888888889
"Chr08","1789902","T","A",31,14,45,160,23,21,44,160,0.477272727272727,0.311111111111111,0.606741573033708,0.166161616161616
"Chr08","1790113","A","G",43,29,72,160,29,48,77,160,0.623376623376623,0.402777777777778,0.483221476510067,0.220598845598846
"Chr08","1790812","G","T",57,43,100,160,43,34,77,160,0.441558441558442,0.43,0.564971751412429,0.0115584415584415
"Chr08","1790823","A","G",54,42,96,160,41,35,76,160,0.460526315789474,0.4375,0.552325581395349,0.0230263157894737
"Chr08","1790829","G","A",54,39,93,144,40,32,72,144,0.444444444444444,0.419354838709677,0.56969696969697,0.025089605734767
"Chr08","1791232","G","A",50,34,84,143,57,45,102,143,0.441176470588235,0.404761904761905,0.575268817204301,0.0364145658263305
"Chr08","1791391","T","C",64,55,119,140,56,45,101,140,0.445544554455446,0.46218487394958,0.545454545454545,-0.0166403194941343
"Chr08","1791418","G","A",59,52,111,136,55,45,100,136,0.45,0.468468468468468,0.540284360189573,-0.0184684684684684
"Chr08","1791814","A","G",19,14,33,151,16,23,39,151,0.58974358974359,0.424242424242424,0.486111111111111,0.165501165501166
"Chr08","1791898","T","C",22,20,42,144,26,29,55,144,0.527272727272727,0.476190476190476,0.494845360824742,0.0510822510822511
"Chr08","1791981","C","T",23,19,42,160,28,32,60,160,0.533333333333333,0.452380952380952,0.5,0.0809523809523809
"Chr08","1792935","T","C",80,52,132,160,90,81,171,160,0.473684210526316,0.393939393939394,0.561056105610561,0.0797448165869218
"Chr08","1793061","C","T",57,51,108,160,85,66,151,160,0.437086092715232,0.472222222222222,0.548262548262548,-0.0351361295069904
"Chr08","1795218","G","T",117,52,169,160,109,103,212,160,0.485849056603774,0.307692307692308,0.593175853018373,0.178156748911466
"Chr08","1795905","C","A",63,51,114,151,77,77,154,151,0.5,0.447368421052632,0.522388059701492,0.0526315789473684
"Chr08","1796354","T","C",89,45,134,143,94,77,171,143,0.450292397660819,0.335820895522388,0.6,0.114471502138431
"Chr08","1796393","C","T",86,54,140,153,93,75,168,153,0.446428571428571,0.385714285714286,0.581168831168831,0.0607142857142857
"Chr08","1796866","C","T",75,47,122,143,60,56,116,143,0.482758620689655,0.385245901639344,0.567226890756303,0.0975127190503109
"Chr08","1797827","C","T",40,26,66,160,41,37,78,160,0.474358974358974,0.393939393939394,0.5625,0.0804195804195804
"Chr08","1798417","G","A",87,41,128,136,93,83,176,136,0.471590909090909,0.3203125,0.592105263157895,0.151278409090909
"Chr08","1798851","T","C",82,60,142,160,80,102,182,160,0.56043956043956,0.422535211267606,0.5,0.137904349171955
"Chr08","1798964","C","T",74,40,114,141,58,70,128,141,0.546875,0.350877192982456,0.545454545454545,0.195997807017544
"Chr08","1799177","C","T",50,27,77,141,44,43,87,141,0.494252873563218,0.350649350649351,0.573170731707317,0.143603522913868
"Chr08","1799445","C","T",18,24,42,160,25,17,42,160,0.404761904761905,0.571428571428571,0.511904761904762,-0.166666666666667
"Chr08","1799522","A","C",19,19,38,148,29,24,53,148,0.452830188679245,0.5,0.527472527472527,-0.0471698113207547
"Chr08","1800079","C","T",4,12,16,73,9,12,21,156,0.571428571428571,0.75,0.351351351351351,-0.178571428571429
"Chr08","1801664","A","G",17,11,28,142,19,18,37,142,0.486486486486487,0.392857142857143,0.553846153846154,0.0936293436293437
"Chr08","1801953","G","T",16,7,23,133,19,20,39,160,0.512820512820513,0.304347826086957,0.564516129032258,0.208472686733556
"Chr08","1802293","A","G",21,15,36,141,13,28,41,141,0.682926829268293,0.416666666666667,0.441558441558442,0.266260162601626
"Chr08","1803221","C","A",33,21,54,147,31,41,72,147,0.569444444444444,0.388888888888889,0.507936507936508,0.180555555555556
"Chr08","1803479","T","G",39,32,71,148,56,56,112,148,0.5,0.450704225352113,0.519125683060109,0.0492957746478873
"Chr08","1806351","G","A",65,47,112,160,84,83,167,160,0.497005988023952,0.419642857142857,0.53405017921147,0.0773631308810949
"Chr08","1806962","A","G",93,56,149,136,113,90,203,136,0.443349753694581,0.375838926174497,0.585227272727273,0.0675108275200846
"Chr08","1807693","T","G",82,54,136,139,96,83,179,139,0.463687150837989,0.397058823529412,0.565079365079365,0.0666283273085771
"Chr08","1808488","C","A",101,70,171,160,102,99,201,160,0.492537313432836,0.409356725146199,0.545698924731183,0.083180588286637
"Chr08","1808823","A","C",71,55,126,160,67,69,136,160,0.507352941176471,0.436507936507937,0.526717557251908,0.0708450046685341
"Chr08","1808903","A","G",49,48,97,160,69,51,120,160,0.425,0.494845360824742,0.543778801843318,-0.0698453608247423
"Chr08","1808946","G","T",41,42,83,139,57,51,108,139,0.472222222222222,0.506024096385542,0.513089005235602,-0.0338018741633199
"Chr08","1809512","T","C",46,24,70,146,54,37,91,146,0.406593406593407,0.342857142857143,0.62111801242236,0.0637362637362637
"Chr08","1810885","A","T",87,66,153,160,74,110,184,160,0.597826086956522,0.431372549019608,0.477744807121662,0.166453537936914
"Chr08","1811165","G","C",102,66,168,160,63,95,158,160,0.60126582278481,0.392857142857143,0.506134969325153,0.208408679927667
"Chr08","1811482","G","C",89,77,166,160,116,112,228,160,0.491228070175439,0.463855421686747,0.520304568527919,0.0273726484886916
"Chr08","1812764","G","A",51,41,92,160,53,52,105,160,0.495238095238095,0.445652173913043,0.527918781725888,0.0495859213250518
"Chr08","1813805","T","C",41,27,68,160,34,33,67,160,0.492537313432836,0.397058823529412,0.555555555555556,0.0954784899034241
"Chr08","1813934","T","A",54,46,100,160,59,45,104,160,0.432692307692308,0.46,0.553921568627451,-0.0273076923076923
"Chr08","1814551","T","G",38,27,65,160,50,43,93,160,0.462365591397849,0.415384615384615,0.556962025316456,0.046980976013234
"Chr08","1815061","A","G",42,40,82,160,70,61,131,160,0.465648854961832,0.48780487804878,0.525821596244131,-0.0221560230869484
"Chr08","1815254","T","G",57,42,99,160,81,54,135,160,0.4,0.424242424242424,0.58974358974359,-0.0242424242424242
"Chr08","1818792","T","C",113,63,176,139,116,115,231,139,0.497835497835498,0.357954545454545,0.562653562653563,0.139880952380952
"Chr08","1820731","T","A",70,52,122,142,79,70,149,142,0.469798657718121,0.426229508196721,0.549815498154982,0.0435691495213995
"Chr08","1820883","C","T",80,42,122,160,90,67,157,160,0.426751592356688,0.344262295081967,0.609318996415771,0.0824892972747207
"Chr08","1820954","C","A",78,51,129,160,97,77,174,160,0.442528735632184,0.395348837209302,0.577557755775578,0.0471798984228816
"Chr08","1821013","A","G",65,54,119,160,101,77,178,160,0.432584269662921,0.453781512605042,0.558922558922559,-0.0211972429421207
"Chr08","1824082","G","A",31,19,50,160,32,36,68,160,0.529411764705882,0.38,0.533898305084746,0.149411764705882
"Chr08","1824093","T","G",30,18,48,143,33,35,68,143,0.514705882352941,0.375,0.543103448275862,0.139705882352941
"Chr08","1824098","A","G",32,15,47,160,32,37,69,160,0.536231884057971,0.319148936170213,0.551724137931034,0.217082947887758
"Chr08","1826456","C","G",86,61,147,139,119,109,228,139,0.478070175438596,0.414965986394558,0.546666666666667,0.0631041890440386
"Chr08","1828232","G","A",93,76,169,139,106,80,186,139,0.43010752688172,0.449704142011834,0.56056338028169,-0.0195966151301139
"Chr08","1828654","G","A",80,52,132,140,64,57,121,140,0.471074380165289,0.393939393939394,0.569169960474308,0.0771349862258953
"Chr08","1830077","C","T",57,39,96,160,66,61,127,160,0.480314960629921,0.40625,0.551569506726457,0.0740649606299212
"Chr08","1832357","T","C",108,62,170,138,109,86,195,138,0.441025641025641,0.364705882352941,0.594520547945205,0.0763197586726999
"Chr08","1832553","T","A",76,66,142,160,78,89,167,160,0.532934131736527,0.464788732394366,0.498381877022654,0.0681453993421607
"Chr08","1832851","T","A",86,51,137,137,102,99,201,137,0.492537313432836,0.372262773722628,0.556213017751479,0.120274539710208
"Chr08","1835804","A","G",84,54,138,148,104,90,194,148,0.463917525773196,0.391304347826087,0.566265060240964,0.0726131779471089
"Chr08","1835843","G","A",83,55,138,141,114,88,202,141,0.435643564356436,0.398550724637681,0.579411764705882,0.0370928397187545
"Chr08","1835870","A","G",81,50,131,160,102,80,182,160,0.43956043956044,0.381679389312977,0.584664536741214,0.0578810502474624
"Chr08","1836001","A","G",78,27,105,139,77,75,152,139,0.493421052631579,0.257142857142857,0.603112840466926,0.236278195488722
"Chr08","1836059","C","G",79,33,112,160,67,75,142,160,0.528169014084507,0.294642857142857,0.574803149606299,0.23352615694165
"Chr08","1836108","T","G",83,37,120,143,69,64,133,143,0.481203007518797,0.308333333333333,0.600790513833992,0.172869674185464
"Chr08","1836175","C","A",78,52,130,144,90,61,151,144,0.403973509933775,0.4,0.597864768683274,0.00397350993377482
"Chr08","1836182","T","A",80,49,129,142,98,61,159,142,0.383647798742138,0.37984496124031,0.618055555555556,0.0038028375018283
"Chr08","1836207","A","G",79,81,160,138,96,157,253,138,0.620553359683794,0.50625,0.423728813559322,0.114303359683794
"Chr08","1836447","T","G",83,33,116,160,69,72,141,160,0.51063829787234,0.28448275862069,0.591439688715953,0.226155539251651
"Chr08","1836462","A","G",79,34,113,160,62,65,127,160,0.511811023622047,0.300884955752212,0.5875,0.210926067869835
"Chr08","1836500","A","G",76,29,105,141,53,67,120,141,0.558333333333333,0.276190476190476,0.573333333333333,0.282142857142857
"Chr08","1836539","T","C",76,38,114,160,67,74,141,160,0.524822695035461,0.333333333333333,0.56078431372549,0.191489361702128
"Chr08","1836552","A","G",72,44,116,160,72,78,150,160,0.52,0.379310344827586,0.541353383458647,0.140689655172414
"Chr08","1836587","T","C",64,42,106,160,62,68,130,160,0.523076923076923,0.39622641509434,0.533898305084746,0.126850507982583
"Chr08","1836605","T","C",63,38,101,151,65,61,126,151,0.484126984126984,0.376237623762376,0.563876651982379,0.107889360364608
"Chr08","1836669","G","A",78,49,127,160,99,84,183,160,0.459016393442623,0.385826771653543,0.570967741935484,0.0731896217890797
"Chr08","1836776","C","T",91,70,161,136,111,105,216,136,0.486111111111111,0.434782608695652,0.535809018567639,0.0513285024154589
"Chr08","1836810","A","C",84,57,141,160,87,99,186,160,0.532258064516129,0.404255319148936,0.522935779816514,0.128002745367193
"Chr08","1836888","A","G",95,54,149,135,78,90,168,135,0.535714285714286,0.36241610738255,0.545741324921136,0.173298178331735
"Chr08","1836904","A","G",95,55,150,160,81,93,174,160,0.53448275862069,0.366666666666667,0.54320987654321,0.167816091954023
"Chr08","1837020","G","C",53,41,94,160,65,61,126,160,0.484126984126984,0.436170212765957,0.536363636363636,0.0479567713610267
"Chr08","1837113","T","C",72,39,111,160,81,59,140,160,0.421428571428571,0.351351351351351,0.609561752988048,0.0700772200772201
"Chr08","1837403","A","G",108,65,173,160,120,106,226,160,0.469026548672566,0.375722543352601,0.571428571428571,0.0933040053199652
"Chr08","1837577","G","T",75,44,119,140,88,84,172,140,0.488372093023256,0.369747899159664,0.560137457044674,0.118624193863592
"Chr08","1837625","A","G",86,52,138,139,92,85,177,139,0.480225988700565,0.376811594202899,0.565079365079365,0.103414394497666
"Chr08","1837705","T","C",89,54,143,136,111,79,190,136,0.415789473684211,0.377622377622378,0.600600600600601,0.0381670960618329
"Chr08","1837722","C","T",101,56,157,142,119,77,196,142,0.392857142857143,0.356687898089172,0.623229461756374,0.0361692447679709
"Chr08","1837873","G","C",120,71,191,160,129,123,252,160,0.488095238095238,0.371727748691099,0.562076749435666,0.116367489404139
"Chr08","1837928","G","T",111,66,177,138,132,118,250,138,0.472,0.372881355932203,0.569086651053864,0.0991186440677966
"Chr08","1838053","C","T",84,48,132,139,89,65,154,139,0.422077922077922,0.363636363636364,0.604895104895105,0.0584415584415584
"Chr08","1838447","G","T",85,60,145,160,99,87,186,160,0.467741935483871,0.413793103448276,0.555891238670695,0.0539488320355951
"Chr08","1838471","A","T",78,61,139,140,93,88,181,140,0.486187845303867,0.438848920863309,0.534375,0.047338924440558
"Chr08","1838554","C","T",69,45,114,140,90,56,146,140,0.383561643835616,0.394736842105263,0.611538461538462,-0.0111751982696467
"Chr08","1838561","C","T",69,46,115,151,86,56,142,151,0.394366197183099,0.4,0.603112840466926,-0.00563380281690146
"Chr08","1838566","T","C",71,46,117,143,88,57,145,143,0.393103448275862,0.393162393162393,0.606870229007634,-5.8944886531076e-05
"Chr08","1838589","T","C",61,37,98,141,77,47,124,141,0.379032258064516,0.377551020408163,0.621621621621622,0.00148123765635289
"Chr08","1839095","T","C",48,47,95,160,50,61,111,160,0.54954954954955,0.494736842105263,0.475728155339806,0.0548127074442865
"Chr08","1839332","C","T",55,39,94,146,50,39,89,146,0.438202247191011,0.414893617021277,0.573770491803279,0.0233086301697347
"Chr08","1839355","G","A",82,70,152,136,74,79,153,136,0.516339869281046,0.460526315789474,0.511475409836066,0.0558135534915721
"Chr08","1839376","G","A",82,71,153,160,66,85,151,160,0.562913907284768,0.464052287581699,0.486842105263158,0.0988616197030688
"Chr08","1839478","G","A",75,69,144,147,73,88,161,147,0.546583850931677,0.479166666666667,0.485245901639344,0.0674171842650104
"Chr08","1839502","C","T",68,66,134,141,82,90,172,141,0.523255813953488,0.492537313432836,0.490196078431373,0.0307185005206526
"Chr08","1839559","G","A",77,78,155,160,91,83,174,160,0.477011494252874,0.503225806451613,0.51063829787234,-0.0262143121987393
"Chr08","1839685","G","A",52,43,95,150,81,80,161,150,0.496894409937888,0.452631578947368,0.51953125,0.0442628309905198
"Chr08","1839708","G","T",60,46,106,139,85,87,172,139,0.505813953488372,0.433962264150943,0.52158273381295,0.0718516893374287
"Chr08","1839732","G","A",48,44,92,140,69,78,147,140,0.530612244897959,0.478260869565217,0.489539748953975,0.0523513753327418
"Chr08","1840494","C","G",30,12,42,160,24,30,54,160,0.555555555555556,0.285714285714286,0.5625,0.26984126984127
"Chr08","1842538","T","A",25,21,46,148,22,24,46,148,0.521739130434783,0.456521739130435,0.510869565217391,0.0652173913043478
"Chr08","1842667","T","C",30,23,53,160,32,27,59,160,0.457627118644068,0.433962264150943,0.553571428571429,0.0236648544931244
"Chr08","1842723","A","G",30,25,55,139,33,29,62,139,0.467741935483871,0.454545454545455,0.538461538461538,0.0131964809384164
"Chr08","1842728","T","C",31,25,56,160,32,28,60,160,0.466666666666667,0.446428571428571,0.543103448275862,0.0202380952380952
"Chr08","1842814","C","G",27,9,36,139,19,15,34,160,0.441176470588235,0.25,0.657142857142857,0.191176470588235
"Chr08","1843430","C","T",35,25,60,160,47,26,73,160,0.356164383561644,0.416666666666667,0.616541353383459,-0.0605022831050229
"Chr08","1843475","C","T",38,31,69,160,52,46,98,160,0.469387755102041,0.449275362318841,0.538922155688623,0.0201123927832003
"Chr08","1843485","G","A",43,29,72,147,52,45,97,147,0.463917525773196,0.402777777777778,0.562130177514793,0.0611397479954181
"Chr08","1843674","G","A",47,29,76,140,52,45,97,140,0.463917525773196,0.381578947368421,0.572254335260116,0.0823385784047748
"Chr08","1843686","T","G",48,28,76,155,57,44,101,155,0.435643564356436,0.368421052631579,0.593220338983051,0.0672225117248567
"Chr08","1843693","C","T",47,29,76,141,57,45,102,141,0.441176470588235,0.381578947368421,0.584269662921348,0.0595975232198142
"Chr08","1843717","C","A",57,36,93,160,57,43,100,160,0.43,0.387096774193548,0.590673575129534,0.0429032258064516
"Chr08","1845226","G","A",30,29,59,151,48,32,80,151,0.4,0.491525423728814,0.561151079136691,-0.0915254237288136
"Chr08","1845239","C","T",31,32,63,160,45,32,77,160,0.415584415584416,0.507936507936508,0.542857142857143,-0.0923520923520923
"Chr08","1846511","C","T",71,56,127,160,82,59,141,160,0.418439716312057,0.440944881889764,0.57089552238806,-0.022505165577707
"Chr08","1850894","T","C",85,67,152,142,93,82,175,142,0.468571428571429,0.440789473684211,0.54434250764526,0.0277819548872181
"Chr08","1852390","C","A",55,31,86,140,72,50,122,140,0.409836065573771,0.36046511627907,0.610576923076923,0.0493709492947008
"Chr08","1852972","G","A",29,25,54,139,52,32,84,139,0.380952380952381,0.462962962962963,0.58695652173913,-0.082010582010582
"Chr08","1852978","A","G",24,31,55,142,52,39,91,142,0.428571428571429,0.563636363636364,0.520547945205479,-0.135064935064935
"Chr08","1852987","G","A",29,37,66,160,51,54,105,160,0.514285714285714,0.560606060606061,0.467836257309941,-0.0463203463203463
"Chr08","1853027","G","A",33,20,53,160,52,42,94,160,0.446808510638298,0.377358490566038,0.578231292517007,0.0694500200722601
"Chr08","1853087","T","C",31,25,56,142,49,47,96,142,0.489583333333333,0.446428571428571,0.526315789473684,0.0431547619047619
"Chr08","1853131","A","T",35,21,56,144,54,38,92,144,0.41304347826087,0.375,0.601351351351351,0.0380434782608696
"Chr08","1853145","C","T",37,27,64,160,57,41,98,160,0.418367346938776,0.421875,0.580246913580247,-0.00350765306122447
"Chr08","1853366","G","A",82,62,144,160,113,93,206,160,0.451456310679612,0.430555555555556,0.557142857142857,0.0209007551240561
"Chr08","1853487","A","G",63,58,121,160,75,69,144,160,0.479166666666667,0.479338842975207,0.520754716981132,-0.00017217630853994
"Chr08","1853836","T","C",70,40,110,160,63,49,112,160,0.4375,0.363636363636364,0.599099099099099,0.0738636363636364
"Chr08","1853944","C","A",59,37,96,143,55,55,110,143,0.5,0.385416666666667,0.553398058252427,0.114583333333333
"Chr08","1854053","C","T",45,36,81,141,46,56,102,141,0.549019607843137,0.444444444444444,0.497267759562842,0.104575163398693
"Chr08","1854075","C","T",54,43,97,148,52,58,110,148,0.527272727272727,0.443298969072165,0.51207729468599,0.0839737582005623
"Chr08","1854250","G","A",76,43,119,142,46,42,88,142,0.477272727272727,0.361344537815126,0.589371980676328,0.115928189457601
"Chr08","1854329","A","G",75,36,111,160,62,52,114,160,0.456140350877193,0.324324324324324,0.608888888888889,0.131816026552869
"Chr08","1854422","A","G",64,28,92,160,49,42,91,160,0.461538461538462,0.304347826086957,0.617486338797814,0.157190635451505
"Chr08","1854709","G","A",75,52,127,146,59,66,125,146,0.528,0.409448818897638,0.531746031746032,0.118551181102362
"Chr08","1854753","T","A",60,45,105,139,56,65,121,139,0.537190082644628,0.428571428571429,0.513274336283186,0.1086186540732
"Chr08","1854815","A","G",58,39,97,160,59,69,128,160,0.5390625,0.402061855670103,0.52,0.137000644329897
"Chr08","1854998","T","C",47,48,95,160,63,69,132,160,0.522727272727273,0.505263157894737,0.484581497797357,0.0174641148325358
"Chr08","1855035","C","T",51,36,87,142,62,69,131,142,0.526717557251908,0.413793103448276,0.518348623853211,0.112924453803633
"Chr08","1855085","T","G",59,32,91,160,71,54,125,160,0.432,0.351648351648352,0.601851851851852,0.0803516483516483
"Chr08","1855454","C","T",83,51,134,142,76,58,134,142,0.432835820895522,0.380597014925373,0.593283582089552,0.0522388059701492
"Chr08","1855558","C","T",65,54,119,160,76,73,149,160,0.48993288590604,0.453781512605042,0.526119402985075,0.0361513733009983
"Chr08","1855668","C","T",79,71,150,160,84,90,174,160,0.517241379310345,0.473333333333333,0.503086419753086,0.0439080459770115
"Chr08","1855807","A","G",108,76,184,138,98,77,175,138,0.44,0.41304347826087,0.573816155988858,0.0269565217391304
"Chr08","1855962","G","T",77,49,126,160,74,56,130,160,0.430769230769231,0.388888888888889,0.58984375,0.0418803418803419
"Chr08","1856445","A","G",77,51,128,141,89,68,157,141,0.43312101910828,0.3984375,0.582456140350877,0.0346835191082803
"Chr08","1856618","G","A",60,61,121,154,71,57,128,154,0.4453125,0.504132231404959,0.526104417670683,-0.0588197314049587
"Chr08","1856930","T","C",72,100,172,160,80,126,206,160,0.611650485436893,0.581395348837209,0.402116402116402,0.0302551365996838
"Chr08","1857547","T","C",28,8,36,137,24,27,51,143,0.529411764705882,0.222222222222222,0.597701149425287,0.30718954248366
"Chr08","1857617","A","G",23,14,37,143,23,30,53,143,0.566037735849057,0.378378378378378,0.511111111111111,0.187659357470678
"Chr08","1857673","C","G",25,21,46,155,22,27,49,155,0.551020408163265,0.456521739130435,0.494736842105263,0.0944986690328305
"Chr08","1858124","A","G",37,31,68,160,33,39,72,160,0.541666666666667,0.455882352941176,0.5,0.0857843137254902
"Chr08","1858333","C","T",7,8,15,136,7,16,23,140,0.695652173913043,0.533333333333333,0.368421052631579,0.16231884057971
"Chr08","1858346","C","T",7,7,14,128,6,12,18,133,0.666666666666667,0.5,0.40625,0.166666666666667
"Chr08","1858369","C","T",7,8,15,108,5,12,17,101,0.705882352941177,0.533333333333333,0.375,0.172549019607843
"Chr08","1861796","G","T",65,63,128,160,64,89,153,160,0.581699346405229,0.4921875,0.459074733096085,0.0895118464052288
"Chr08","1862264","G","A",57,33,90,147,50,60,110,147,0.545454545454545,0.366666666666667,0.535,0.178787878787879
"Chr08","1862611","A","T",76,59,135,140,95,80,175,140,0.457142857142857,0.437037037037037,0.551612903225806,0.0201058201058201
"Chr08","1863366","A","G",82,77,159,160,66,98,164,160,0.597560975609756,0.484276729559748,0.458204334365325,0.113284246050008
"Chr08","1864032","G","A",82,79,161,141,89,86,175,141,0.491428571428571,0.490683229813665,0.508928571428571,0.000745341614906858
"Chr08","1864081","T","C",74,81,155,160,71,81,152,160,0.532894736842105,0.52258064516129,0.472312703583062,0.010314091680815
"Chr08","1864122","A","C",64,61,125,160,67,59,126,160,0.468253968253968,0.488,0.52191235059761,-0.0197460317460317
"Chr08","1864150","A","G",64,59,123,150,77,58,135,150,0.42962962962963,0.479674796747967,0.546511627906977,-0.0500451671183378
"Chr08","1864262","T","C",52,46,98,160,68,35,103,160,0.339805825242718,0.469387755102041,0.597014925373134,-0.129581929859322
"Chr08","1864294","C","T",45,35,80,139,54,24,78,139,0.307692307692308,0.4375,0.626582278481013,-0.129807692307692
"Chr08","1864351","G","C",30,30,60,151,27,20,47,151,0.425531914893617,0.5,0.532710280373832,-0.074468085106383
"Chr08","1864791","T","G",30,22,52,160,41,33,74,160,0.445945945945946,0.423076923076923,0.563492063492063,0.0228690228690229
"Chr08","1864812","C","A",37,21,58,160,42,39,81,160,0.481481481481481,0.362068965517241,0.568345323741007,0.11941251596424
"Chr08","1864882","C","T",43,28,71,144,48,34,82,144,0.414634146341463,0.394366197183099,0.594771241830065,0.0202679491583648
"Chr08","1865030","C","T",39,24,63,144,48,34,82,144,0.414634146341463,0.380952380952381,0.6,0.0336817653890825
"Chr08","1865087","T","C",41,21,62,160,46,32,78,160,0.41025641025641,0.338709677419355,0.621428571428571,0.0715467328370554
"Chr08","1865130","G","A",45,20,65,144,44,33,77,144,0.428571428571429,0.307692307692308,0.626760563380282,0.120879120879121
"Chr08","1865175","C","T",42,17,59,160,35,30,65,160,0.461538461538462,0.288135593220339,0.620967741935484,0.173402868318123
"Chr08","1865213","G","A",38,24,62,160,39,36,75,160,0.48,0.387096774193548,0.562043795620438,0.0929032258064516
"Chr08","1865344","G","A",29,20,49,160,42,26,68,160,0.382352941176471,0.408163265306122,0.606837606837607,-0.0258103241296519
"Chr08","1865498","T","G",57,29,86,160,42,38,80,160,0.475,0.337209302325581,0.596385542168675,0.137790697674419
"Chr08","1865638","G","A",43,25,68,160,53,36,89,160,0.404494382022472,0.367647058823529,0.611464968152866,0.0368473231989425
"Chr08","1865659","G","A",43,29,72,147,51,40,91,147,0.43956043956044,0.402777777777778,0.576687116564417,0.0367826617826618
"Chr08","1866074","G","C",54,31,85,160,59,49,108,160,0.453703703703704,0.364705882352941,0.585492227979275,0.0889978213507626
"Chr08","1866113","G","A",40,39,79,160,51,50,101,160,0.495049504950495,0.493670886075949,0.505555555555556,0.00137861887454566
"Chr08","1866232","G","A",27,25,52,160,27,38,65,160,0.584615384615385,0.480769230769231,0.461538461538462,0.103846153846154
"Chr08","1866275","C","T",33,36,69,147,28,41,69,147,0.594202898550725,0.521739130434783,0.442028985507246,0.072463768115942
"Chr08","1866327","A","T",37,41,78,160,38,51,89,160,0.573033707865168,0.525641025641026,0.449101796407186,0.0473926822241428
"Chr08","1866361","C","T",41,35,76,142,42,45,87,142,0.517241379310345,0.460526315789474,0.50920245398773,0.0567150635208712
"Chr08","1866388","C","T",42,35,77,160,47,37,84,160,0.44047619047619,0.454545454545455,0.552795031055901,-0.0140692640692641
"Chr08","1866455","C","G",34,23,57,141,39,36,75,141,0.48,0.403508771929825,0.553030303030303,0.0764912280701754
"Chr08","1866461","G","A",33,25,58,160,39,39,78,160,0.5,0.431034482758621,0.529411764705882,0.0689655172413793
"Chr08","1866488","T","C",28,23,51,160,47,45,92,160,0.489130434782609,0.450980392156863,0.524475524475524,0.038150042625746
"Chr08","1866540","T","C",19,26,45,160,53,49,102,160,0.480392156862745,0.577777777777778,0.489795918367347,-0.0973856209150326
"Chr08","1866561","T","C",22,29,51,142,52,50,102,142,0.490196078431373,0.568627450980392,0.483660130718954,-0.0784313725490196
"Chr08","1866596","T","C",34,31,65,160,56,52,108,160,0.481481481481481,0.476923076923077,0.520231213872832,0.00455840455840451
"Chr08","1866607","G","A",36,30,66,160,56,51,107,160,0.476635514018692,0.454545454545455,0.531791907514451,0.0220900594732371
"Chr08","1866670","C","T",38,28,66,160,47,30,77,160,0.38961038961039,0.424242424242424,0.594405594405594,-0.0346320346320346
"Chr08","1866950","A","G",63,30,93,140,69,63,132,140,0.477272727272727,0.32258064516129,0.586666666666667,0.154692082111437
"Chr08","1867274","A","G",64,33,97,160,71,59,130,160,0.453846153846154,0.34020618556701,0.594713656387665,0.113639968279144
"Chr08","1867422","T","C",87,44,131,137,100,79,179,137,0.441340782122905,0.33587786259542,0.603225806451613,0.105462919527485
"Chr08","1867543","A","G",64,46,110,160,51,48,99,160,0.484848484848485,0.418181818181818,0.550239234449761,0.0666666666666667
"Chr08","1867619","A","G",72,49,121,160,67,52,119,160,0.436974789915966,0.40495867768595,0.579166666666667,0.032016112230016
"Chr08","1867875","A","G",30,47,77,141,42,50,92,141,0.543478260869565,0.61038961038961,0.42603550295858,-0.0669113495200452
"Chr08","1867959","T","C",37,36,73,141,35,50,85,141,0.588235294117647,0.493150684931507,0.455696202531646,0.0950846091861403
"Chr08","1867987","C","T",35,27,62,160,38,43,81,160,0.530864197530864,0.435483870967742,0.510489510489511,0.0953803265631223
"Chr08","1868044","C","T",41,27,68,160,41,53,94,160,0.563829787234043,0.397058823529412,0.506172839506173,0.166770963704631
"Chr08","1868068","T","G",44,31,75,143,42,52,94,143,0.553191489361702,0.413333333333333,0.50887573964497,0.139858156028369
"Chr08","1868142","G","A",55,36,91,160,51,63,114,160,0.552631578947368,0.395604395604396,0.517073170731707,0.157027183342973
"Chr08","1868180","T","G",58,37,95,160,45,55,100,160,0.55,0.389473684210526,0.528205128205128,0.160526315789474
"Chr08","1868268","A","C",54,31,85,146,61,50,111,146,0.45045045045045,0.364705882352941,0.586734693877551,0.0857445680975093
"Chr08","1868302","G","A",56,28,84,160,61,58,119,160,0.487394957983193,0.333333333333333,0.576354679802956,0.15406162464986
"Chr08","1868316","T","C",52,22,74,141,59,55,114,141,0.482456140350877,0.297297297297297,0.590425531914894,0.18515884305358
"Chr08","1868353","A","G",57,30,87,160,47,56,103,160,0.543689320388349,0.344827586206897,0.547368421052632,0.198861734181453
"Chr08","1868372","T","C",53,33,86,160,48,50,98,160,0.510204081632653,0.383720930232558,0.548913043478261,0.126483151400095
"Chr08","1868414","T","C",57,41,98,139,53,52,105,139,0.495238095238095,0.418367346938776,0.541871921182266,0.0768707482993197
"Chr08","1868504","T","A",48,38,86,140,48,54,102,140,0.529411764705882,0.441860465116279,0.51063829787234,0.0875512995896033
"Chr08","1868619","C","G",66,45,111,160,78,73,151,160,0.483443708609272,0.405405405405405,0.549618320610687,0.0780383032038661
"Chr08","1868781","A","G",34,26,60,160,41,41,82,160,0.5,0.433333333333333,0.528169014084507,0.0666666666666667
"Chr08","1868821","A","C",24,26,50,160,32,21,53,160,0.39622641509434,0.52,0.543689320388349,-0.12377358490566
"Chr08","1868891","T","G",15,24,39,160,19,22,41,160,0.536585365853659,0.615384615384615,0.425,-0.0787992495309568
"Chr08","1868976","C","T",18,15,33,160,20,23,43,160,0.534883720930233,0.454545454545455,0.5,0.080338266384778
"Chr08","1869103","C","T",13,23,36,143,20,25,45,143,0.555555555555556,0.638888888888889,0.407407407407407,-0.0833333333333333
"Chr08","1869631","G","T",32,31,63,160,43,40,83,160,0.481927710843373,0.492063492063492,0.513698630136986,-0.0101357812201185
"Chr08","1869735","G","T",63,48,111,160,69,76,145,160,0.524137931034483,0.432432432432432,0.515625,0.0917054986020504
"Chr08","1869765","C","A",59,40,99,160,66,70,136,160,0.514705882352941,0.404040404040404,0.531914893617021,0.110665478312537
"Chr08","1869793","T","C",64,36,100,144,73,67,140,144,0.478571428571429,0.36,0.570833333333333,0.118571428571429
"Chr08","1870071","A","G",65,54,119,139,79,71,150,139,0.473333333333333,0.453781512605042,0.535315985130111,0.0195518207282913
"Chr08","1870086","G","C",75,62,137,160,86,77,163,160,0.47239263803681,0.452554744525547,0.536666666666667,0.0198378935112624
"Chr08","1870268","G","C",90,50,140,160,80,81,161,160,0.503105590062112,0.357142857142857,0.564784053156146,0.145962732919255
"Chr08","1870273","G","T",89,50,139,160,83,80,163,160,0.49079754601227,0.359712230215827,0.56953642384106,0.131085315796443
"Chr08","1870347","C","T",101,69,170,160,119,97,216,160,0.449074074074074,0.405882352941176,0.569948186528497,0.0431917211328976
"Chr08","1870431","T","A",86,60,146,160,91,86,177,160,0.485875706214689,0.410958904109589,0.547987616099071,0.0749168021051003
"Chr08","1870609","A","G",112,111,223,160,113,127,240,160,0.529166666666667,0.497757847533632,0.485961123110151,0.0314088191330344
"Chr08","1871019","A","T",89,74,163,160,90,65,155,160,0.419354838709677,0.45398773006135,0.562893081761006,-0.0346328913516722
"Chr08","1871052","G","T",106,74,180,137,115,82,197,137,0.416243654822335,0.411111111111111,0.586206896551724,0.00513254371122396
"Chr08","1871330","T","C",85,40,125,160,92,72,164,160,0.439024390243902,0.32,0.612456747404844,0.119024390243902
"Chr08","1871351","C","T",73,45,118,140,93,70,163,140,0.429447852760736,0.38135593220339,0.590747330960854,0.0480919205573464
"Chr08","1871370","G","A",74,49,123,137,92,67,159,137,0.421383647798742,0.398373983739837,0.588652482269504,0.0230096640589048
"Chr08","1871507","C","T",95,40,135,138,98,85,183,138,0.46448087431694,0.296296296296296,0.606918238993711,0.168184578020644
"Chr08","1871522","C","G",96,38,134,137,93,86,179,137,0.480446927374302,0.283582089552239,0.603833865814696,0.196864837822063
"Chr08","1871701","T","G",72,54,126,147,85,74,159,147,0.465408805031447,0.428571428571429,0.550877192982456,0.036837376460018
"Chr08","1871731","A","G",68,57,125,160,81,74,155,160,0.47741935483871,0.456,0.532142857142857,0.0214193548387097
"Chr08","1871786","C","T",64,57,121,143,78,69,147,143,0.469387755102041,0.471074380165289,0.529850746268657,-0.0016866250632484
"Chr08","1871811","C","T",70,59,129,147,77,63,140,147,0.45,0.457364341085271,0.546468401486989,-0.00736434108527129
"Chr08","1871818","A","G",64,55,119,160,75,57,132,160,0.431818181818182,0.46218487394958,0.553784860557769,-0.030366692131398
"Chr08","1871882","T","C",54,49,103,140,65,54,119,140,0.453781512605042,0.475728155339806,0.536036036036036,-0.0219466427347638
"Chr08","1871903","A","G",53,46,99,160,65,49,114,160,0.429824561403509,0.464646464646465,0.553990610328638,-0.0348219032429559
"Chr08","1871921","G","A",58,50,108,140,67,51,118,140,0.432203389830508,0.462962962962963,0.553097345132743,-0.0307595731324545
"Chr08","1871944","G","T",51,36,87,141,56,47,103,141,0.456310679611651,0.413793103448276,0.563157894736842,0.0425175761633746
"Chr08","1872000","G","A",55,30,85,160,50,52,102,160,0.509803921568627,0.352941176470588,0.561497326203209,0.156862745098039
"Chr08","1872027","A","C",56,37,93,160,60,56,116,160,0.482758620689655,0.397849462365591,0.555023923444976,0.0849091583240638
"Chr08","1872036","T","C",54,37,91,160,66,54,120,160,0.45,0.406593406593407,0.568720379146919,0.0434065934065934
"Chr08","1872053","T","G",55,39,94,160,70,53,123,160,0.430894308943089,0.414893617021277,0.576036866359447,0.0160006919218129
"Chr08","1872059","G","C",54,39,93,142,63,54,117,142,0.461538461538462,0.419354838709677,0.557142857142857,0.0421836228287841
"Chr08","1872228","A","T",26,19,45,160,35,38,73,160,0.520547945205479,0.422222222222222,0.516949152542373,0.0983257229832572
"Chr08","1872253","G","A",27,19,46,160,32,39,71,160,0.549295774647887,0.41304347826087,0.504273504273504,0.136252296387018
"Chr08","1872339","G","A",15,8,23,138,14,30,44,146,0.681818181818182,0.347826086956522,0.432835820895522,0.33399209486166
"Chr08","1872634","T","C",39,32,71,152,27,38,65,152,0.584615384615385,0.450704225352113,0.485294117647059,0.133911159263272
"Chr08","1872733","C","T",35,22,57,144,41,42,83,144,0.506024096385542,0.385964912280702,0.542857142857143,0.12005918410484
"Chr08","1872830","G","A",38,18,56,160,49,36,85,160,0.423529411764706,0.321428571428571,0.617021276595745,0.102100840336134
"Chr08","1872893","A","G",43,31,74,142,48,53,101,142,0.524752475247525,0.418918918918919,0.52,0.105833556328606
"Chr08","1873059","A","C",67,40,107,160,63,55,118,160,0.466101694915254,0.373831775700935,0.577777777777778,0.0922699192143197
"Chr08","1873160","C","T",58,30,88,160,44,39,83,160,0.469879518072289,0.340909090909091,0.596491228070175,0.128970427163198
"Chr08","1873177","G","A",59,33,92,141,45,40,85,141,0.470588235294118,0.358695652173913,0.587570621468927,0.111892583120205
"Chr08","1873234","G","A",39,30,69,160,32,29,61,160,0.475409836065574,0.434782608695652,0.546153846153846,0.0406272273699216
"Chr08","1873532","T","C",32,17,49,139,41,24,65,139,0.369230769230769,0.346938775510204,0.640350877192982,0.0222919937205652
"Chr08","1873632","C","T",7,9,16,137,24,13,37,144,0.351351351351351,0.5625,0.584905660377358,-0.211148648648649
"Chr08","1873749","C","T",8,16,24,160,19,11,30,160,0.366666666666667,0.666666666666667,0.5,-0.3
"Chr08","1873777","G","A",9,22,31,143,22,10,32,143,0.3125,0.709677419354839,0.492063492063492,-0.397177419354839
"Chr08","1873861","C","T",31,27,58,160,41,31,72,160,0.430555555555556,0.46551724137931,0.553846153846154,-0.0349616858237548
"Chr08","1873915","A","G",41,26,67,160,42,33,75,160,0.44,0.388059701492537,0.584507042253521,0.0519402985074627
"Chr08","1874032","A","T",49,43,92,160,60,53,113,160,0.469026548672566,0.467391304347826,0.531707317073171,0.00163524432474027
"Chr08","1874043","A","G",61,47,108,160,65,57,122,160,0.467213114754098,0.435185185185185,0.547826086956522,0.0320279295689132
"Chr08","1874134","C","T",94,63,157,160,71,92,163,160,0.56441717791411,0.401273885350318,0.515625,0.163143292563792
"Chr08","1874139","T","C",97,66,163,160,75,91,166,160,0.548192771084337,0.404907975460123,0.522796352583587,0.143284795624215
"Chr08","1874164","G","T",104,63,167,160,89,90,179,160,0.502793296089385,0.377245508982036,0.557803468208092,0.12554778710735
"Chr08","1874432","T","C",117,68,185,141,115,104,219,141,0.474885844748858,0.367567567567568,0.574257425742574,0.107318277181291
"Chr08","1874456","G","A",111,63,174,160,111,90,201,160,0.447761194029851,0.362068965517241,0.592,0.0856922285126094
"Chr08","1874462","G","A",111,63,174,137,109,89,198,137,0.44949494949495,0.362068965517241,0.591397849462366,0.0874259839777081
"Chr08","1874474","C","T",114,61,175,160,112,86,198,160,0.434343434343434,0.348571428571429,0.605898123324397,0.0857720057720058
"Chr08","1874531","T","C",99,53,152,141,94,81,175,141,0.462857142857143,0.348684210526316,0.590214067278288,0.114172932330827
"Chr08","1874550","G","C",94,47,141,136,89,79,168,136,0.470238095238095,0.333333333333333,0.592233009708738,0.136904761904762
"Chr08","1874631","G","A",89,60,149,142,128,88,216,142,0.407407407407407,0.402684563758389,0.594520547945205,0.00472284364901815
"Chr08","1875009","A","G",74,53,127,143,69,49,118,143,0.415254237288136,0.417322834645669,0.583673469387755,-0.00206859735753367
"Chr08","1875015","C","G",70,54,124,160,62,50,112,160,0.446428571428571,0.435483870967742,0.559322033898305,0.0109447004608295
"Chr08","1875035","C","T",77,53,130,142,59,57,116,142,0.491379310344828,0.407692307692308,0.552845528455285,0.0836870026525199
"Chr08","1875180","G","A",65,29,94,160,66,45,111,160,0.405405405405405,0.308510638297872,0.639024390243902,0.0968947671075331
"Chr08","1875212","T","A",70,35,105,146,72,50,122,146,0.409836065573771,0.333333333333333,0.625550660792952,0.0765027322404372
"Chr08","1875316","A","C",61,43,104,160,50,50,100,160,0.5,0.413461538461538,0.544117647058823,0.0865384615384616
"Chr08","1875358","C","T",59,38,97,139,39,49,88,139,0.556818181818182,0.391752577319588,0.52972972972973,0.165065604498594
"Chr08","1875382","G","A",56,27,83,139,38,45,83,139,0.542168674698795,0.325301204819277,0.566265060240964,0.216867469879518
"Chr08","1875406","C","T",56,19,75,160,30,43,73,160,0.589041095890411,0.253333333333333,0.581081081081081,0.335707762557078
"Chr08","1875417","C","T",46,18,64,160,27,39,66,160,0.590909090909091,0.28125,0.561538461538462,0.309659090909091
"Chr08","1875422","T","C",46,17,63,140,29,40,69,140,0.579710144927536,0.26984126984127,0.568181818181818,0.309868875086266
"Chr08","1875454","T","C",34,20,54,160,40,34,74,160,0.459459459459459,0.37037037037037,0.578125,0.0890890890890891
"Chr08","1875470","G","A",32,20,52,145,41,35,76,145,0.460526315789474,0.384615384615385,0.5703125,0.075910931174089
"Chr08","1875485","G","A",30,20,50,160,45,32,77,160,0.415584415584416,0.4,0.590551181102362,0.0155844155844156
"Chr08","1875511","G","T",36,16,52,160,48,30,78,160,0.384615384615385,0.307692307692308,0.646153846153846,0.0769230769230769
"Chr08","1875528","G","A",32,15,47,142,53,30,83,142,0.36144578313253,0.319148936170213,0.653846153846154,0.0422968469623173
"Chr08","1875545","A","G",30,20,50,141,60,30,90,141,0.333333333333333,0.4,0.642857142857143,-0.0666666666666667
"Chr08","1875570","T","C",35,23,58,160,61,28,89,160,0.314606741573034,0.396551724137931,0.653061224489796,-0.0819449825648974
"Chr08","1875862","T","G",31,18,49,160,33,22,55,160,0.4,0.36734693877551,0.615384615384615,0.0326530612244898
"Chr08","1875978","T","C",39,18,57,160,37,35,72,160,0.486111111111111,0.315789473684211,0.589147286821705,0.170321637426901
"Chr08","1875983","G","T",39,18,57,140,38,34,72,140,0.472222222222222,0.315789473684211,0.596899224806202,0.156432748538012
"Chr08","1876297","C","T",30,16,46,160,29,21,50,160,0.42,0.347826086956522,0.614583333333333,0.0721739130434783
"Chr08","1876371","G","A",30,22,52,160,25,32,57,160,0.56140350877193,0.423076923076923,0.504587155963303,0.138326585695007
"Chr08","1876407","T","G",27,25,52,144,31,40,71,144,0.563380281690141,0.480769230769231,0.471544715447154,0.0826110509209101
"Chr08","1876428","A","G",33,22,55,160,34,40,74,160,0.540540540540541,0.4,0.51937984496124,0.140540540540541
"Chr08","1876479","G","A",31,17,48,146,28,42,70,146,0.6,0.354166666666667,0.5,0.245833333333333
"Chr08","1876490","G","C",30,16,46,142,27,41,68,142,0.602941176470588,0.347826086956522,0.5,0.255115089514066
"Chr08","1876624","A","G",44,24,68,145,36,32,68,145,0.470588235294118,0.352941176470588,0.588235294117647,0.117647058823529
"Chr08","1876700","A","G",67,35,102,140,44,63,107,140,0.588785046728972,0.343137254901961,0.5311004784689,0.245647791827011
"Chr08","1876734","C","T",73,36,109,140,50,66,116,140,0.568965517241379,0.330275229357798,0.546666666666667,0.238690287883581
"Chr08","1876829","T","G",58,39,97,160,56,64,120,160,0.533333333333333,0.402061855670103,0.525345622119816,0.13127147766323
"Chr08","1876860","C","T",57,37,94,145,67,50,117,145,0.427350427350427,0.393617021276596,0.587677725118483,0.0337334060738316
"Chr08","1877043","T","C",31,19,50,160,41,42,83,160,0.506024096385542,0.38,0.541353383458647,0.126024096385542
"Chr08","1877120","G","C",34,19,53,160,39,36,75,160,0.48,0.358490566037736,0.5703125,0.121509433962264
"Chr08","1877163","T","C",27,26,53,160,46,45,91,160,0.494505494505495,0.490566037735849,0.506944444444444,0.00393945676964547
"Chr08","1877267","T","C",40,36,76,150,45,44,89,150,0.49438202247191,0.473684210526316,0.515151515151515,0.0206978119455943
"Chr08","1877370","A","C",40,26,66,160,47,39,86,160,0.453488372093023,0.393939393939394,0.572368421052632,0.0595489781536293
"Chr08","1877413","A","C",36,25,61,144,50,37,87,144,0.425287356321839,0.409836065573771,0.581081081081081,0.0154512907480686
"Chr08","1877611","T","C",63,40,103,160,50,44,94,160,0.468085106382979,0.388349514563107,0.573604060913706,0.0797355918198719
"Chr08","1877686","T","C",62,43,105,142,69,55,124,142,0.443548387096774,0.40952380952381,0.572052401746725,0.0340245775729647
"Chr08","1877693","T","C",58,42,100,142,71,54,125,142,0.432,0.42,0.573333333333333,0.012
"Chr08","1877731","C","G",58,44,102,146,76,82,158,146,0.518987341772152,0.431372549019608,0.515384615384615,0.087614792752544
"Chr08","1877811","C","G",66,50,116,149,62,91,153,149,0.594771241830065,0.431034482758621,0.475836431226766,0.163736759071445
"Chr08","1877837","A","G",57,53,110,160,56,86,142,160,0.605633802816901,0.481818181818182,0.448412698412698,0.12381562099872
"Chr08","1877853","T","C",68,54,122,160,46,84,130,160,0.646153846153846,0.442622950819672,0.452380952380952,0.203530895334174
"Chr08","1877866","G","A",69,56,125,141,49,87,136,141,0.639705882352941,0.448,0.452107279693487,0.191705882352941
"Chr08","1877890","T","A",65,45,110,160,51,66,117,160,0.564102564102564,0.409090909090909,0.511013215859031,0.155011655011655
"Chr08","1878079","C","T",34,19,53,153,42,28,70,153,0.4,0.358490566037736,0.617886178861789,0.0415094339622642
"Chr08","1878302","T","G",14,12,26,160,14,16,30,160,0.533333333333333,0.461538461538462,0.5,0.0717948717948718
"Chr08","1878379","T","C",13,16,29,147,16,16,32,147,0.5,0.551724137931034,0.475409836065574,-0.0517241379310345
"Chr08","1878400","T","C",12,16,28,160,14,10,24,160,0.416666666666667,0.571428571428571,0.5,-0.154761904761905
"Chr08","1878724","G","A",69,33,102,139,52,34,86,139,0.395348837209302,0.323529411764706,0.643617021276596,0.0718194254445964
"Chr08","1878819","A","G",46,26,72,160,45,28,73,160,0.383561643835616,0.361111111111111,0.627586206896552,0.0224505327245053
"Chr08","1879126","C","T",65,36,101,160,103,26,129,160,0.201550387596899,0.356435643564356,0.730434782608696,-0.154885255967457
"Chr08","1879443","A","C",53,35,88,144,61,35,96,144,0.364583333333333,0.397727272727273,0.619565217391304,-0.0331439393939394
"Chr08","1879501","A","G",48,34,82,160,53,44,97,160,0.45360824742268,0.414634146341463,0.564245810055866,0.038974101081217
"Chr08","1879544","G","A",55,35,90,160,68,37,105,160,0.352380952380952,0.388888888888889,0.630769230769231,-0.0365079365079365
"Chr08","1880124","T","G",68,51,119,160,83,65,148,160,0.439189189189189,0.428571428571429,0.565543071161049,0.0106177606177607
"Chr08","1880196","A","G",56,53,109,141,62,66,128,141,0.515625,0.486238532110092,0.49789029535865,0.0293864678899082
"Chr08","1880321","A","C",60,42,102,160,85,77,162,160,0.475308641975309,0.411764705882353,0.549242424242424,0.0635439360929557
"Chr08","1880655","A","G",94,56,150,160,87,93,180,160,0.516666666666667,0.373333333333333,0.548484848484848,0.143333333333333
"Chr08","1880678","A","G",94,56,150,160,98,88,186,160,0.473118279569892,0.373333333333333,0.571428571428571,0.0997849462365591
"Chr08","1881096","T","C",112,73,185,160,97,79,176,160,0.448863636363636,0.394594594594595,0.578947368421053,0.0542690417690417
"Chr08","1882552","A","G",112,49,161,160,89,66,155,160,0.425806451612903,0.304347826086957,0.636075949367089,0.121458625525947
"Chr08","1882672","A","T",94,44,138,138,112,63,175,138,0.36,0.318840579710145,0.65814696485623,0.0411594202898551
"Chr08","1882875","T","C",101,47,148,136,94,50,144,136,0.347222222222222,0.317567567567568,0.667808219178082,0.0296546546546547
"Chr08","1882918","A","C",84,53,137,160,87,48,135,160,0.355555555555556,0.386861313868613,0.628676470588235,-0.0313057583130576
"Chr08","1882932","C","A",92,60,152,136,98,50,148,136,0.337837837837838,0.394736842105263,0.633333333333333,-0.0568990042674253
"Chr08","1882987","C","G",101,81,182,136,100,62,162,136,0.382716049382716,0.445054945054945,0.584302325581395,-0.062338895672229
"Chr08","1883320","A","T",99,68,167,136,100,88,188,136,0.468085106382979,0.407185628742515,0.56056338028169,0.0608994776404638
"Chr08","1883576","T","A",109,69,178,160,115,97,212,160,0.457547169811321,0.387640449438202,0.574358974358974,0.0699067203731185
"Chr08","1883592","G","A",113,77,190,160,117,99,216,160,0.458333333333333,0.405263157894737,0.566502463054187,0.0530701754385965
"Chr08","1883601","G","A",114,74,188,160,116,97,213,160,0.455399061032864,0.393617021276596,0.57356608478803,0.0617820397562681
"Chr08","1883818","C","A",103,72,175,137,130,96,226,137,0.424778761061947,0.411428571428571,0.581047381546135,0.0133501896333755
"Chr08","1884120","G","C",78,63,141,136,96,72,168,136,0.428571428571429,0.446808510638298,0.563106796116505,-0.0182370820668693
"Chr08","1884192","G","T",90,65,155,151,109,66,175,151,0.377142857142857,0.419354838709677,0.603030303030303,-0.0422119815668203
"Chr08","1884862","T","C",48,37,85,145,60,44,104,145,0.423076923076923,0.435294117647059,0.571428571428571,-0.0122171945701358
"Chr08","1886584","G","A",84,52,136,139,95,69,164,139,0.420731707317073,0.382352941176471,0.596666666666667,0.0383787661406026
"Chr08","1886696","C","T",57,45,102,160,55,57,112,160,0.508928571428571,0.441176470588235,0.523364485981308,0.0677521008403361
"Chr08","1887615","C","A",65,38,103,160,90,86,176,160,0.488636363636364,0.368932038834951,0.555555555555556,0.119704324801412
"Chr08","1887848","C","T",13,48,61,160,43,33,76,160,0.434210526315789,0.786885245901639,0.408759124087591,-0.35267471958585
"Chr08","1893432","C","T",90,72,162,137,109,91,200,137,0.455,0.444444444444444,0.549723756906077,0.0105555555555556
"Chr08","1893530","C","T",67,56,123,160,111,64,175,160,0.365714285714286,0.455284552845528,0.597315436241611,-0.0895702671312427
"Chr08","1893897","G","A",35,62,97,160,63,71,134,160,0.529850746268657,0.639175257731959,0.424242424242424,-0.109324511463302
"Chr08","1894329","G","A",33,38,71,150,36,49,85,150,0.576470588235294,0.535211267605634,0.442307692307692,0.0412593206296603
"Chr08","1906993","C","T",28,16,44,160,42,26,68,160,0.382352941176471,0.363636363636364,0.625,0.0187165775401069
"Chr08","1907014","T","C",38,32,70,160,47,41,88,160,0.465909090909091,0.457142857142857,0.537974683544304,0.00876623376623376
"Chr08","1907053","A","G",38,29,67,160,36,39,75,160,0.52,0.432835820895522,0.52112676056338,0.0871641791044777
"Chr08","1907061","A","C",38,32,70,141,37,36,73,141,0.493150684931507,0.457142857142857,0.524475524475524,0.0360078277886497
"Chr08","1907069","G","A",40,35,75,144,32,35,67,144,0.522388059701492,0.466666666666667,0.507042253521127,0.0557213930348258
"Chr08","1907082","T","A",41,39,80,160,29,35,64,160,0.546875,0.4875,0.486111111111111,0.059375
"Chr08","1907175","C","T",82,48,130,144,79,70,149,144,0.469798657718121,0.369230769230769,0.577060931899642,0.100567888487352
"Chr08","1908066","C","G",59,49,108,149,56,61,117,149,0.521367521367521,0.453703703703704,0.511111111111111,0.0676638176638177
"Chr08","1908648","C","G",53,42,95,147,54,45,99,147,0.454545454545455,0.442105263157895,0.551546391752577,0.0124401913875598
"Chr08","3170000","G","A",19,1,20,69,19,13,32,32,0.40625,0.05,0.730769230769231,0.35625
"Chr08","3170121","C","G",0,7,7,18,2,12,14,0,0.857142857142857,1,0.0952380952380952,-0.142857142857143
"Chr08","3590521","T","C",10,1,11,53,11,5,16,29,0.3125,0.0909090909090909,0.777777777777778,0.221590909090909
"Chr08","3590531","G","A",10,1,11,52,10,6,16,18,0.375,0.0909090909090909,0.740740740740741,0.284090909090909
"Chr08","5236023","T","G",72,52,124,160,82,78,160,160,0.4875,0.419354838709677,0.542253521126761,0.0681451612903226
"Chr08","5326676","G","A",6,0,6,26,1,1,2,17,0.5,0,0.875,0.5
"Chr08","5326693","C","G",4,0,4,21,1,0,1,1,0,0,1,0
"Chr08","6236260","C","T",25,18,43,0,22,25,47,11,0.531914893617021,0.418604651162791,0.522222222222222,0.113310242454231
"Chr08","6236273","C","G",25,21,46,75,26,27,53,5,0.509433962264151,0.456521739130435,0.515151515151515,0.0529122231337162
"Chr08","6236295","C","T",27,22,49,83,29,27,56,88,0.482142857142857,0.448979591836735,0.533333333333333,0.0331632653061225
"Chr08","6901244","C","T",8,2,10,4,14,2,16,0,0.125,0.2,0.846153846153846,-0.075
"Chr08","6909373","T","C",11,9,20,47,10,9,19,0,0.473684210526316,0.45,0.538461538461538,0.0236842105263158
"Chr08","7289778","A","C",27,23,50,0,38,36,74,160,0.486486486486487,0.46,0.524193548387097,0.0264864864864865
"Chr08","8553227","G","A",17,8,25,5,9,17,26,23,0.653846153846154,0.32,0.509803921568627,0.333846153846154
"Chr08","8586281","T","A",83,65,148,137,95,95,190,137,0.5,0.439189189189189,0.526627218934911,0.0608108108108108
"Chr08","8721558","C","T",67,74,141,139,63,92,155,139,0.593548387096774,0.524822695035461,0.439189189189189,0.0687256920613132
"Chr08","9109148","A","G",7,4,11,3,1,7,8,36,0.875,0.363636363636364,0.421052631578947,0.511363636363636
"Chr08","9109156","T","C",4,7,11,3,7,1,8,36,0.125,0.636363636363636,0.578947368421053,-0.511363636363636
"Chr08","11320916","T","C",26,19,45,28,25,36,61,137,0.590163934426229,0.422222222222222,0.481132075471698,0.167941712204007
"Chr08","11386923","T","C",4,16,20,21,8,16,24,89,0.666666666666667,0.8,0.272727272727273,-0.133333333333333
"Chr08","11389515","G","T",3,2,5,25,4,2,6,1,0.333333333333333,0.4,0.636363636363636,-0.0666666666666667
"Chr08","11400151","G","A",1,8,9,3,2,5,7,37,0.714285714285714,0.888888888888889,0.1875,-0.174603174603175
"Chr08","11413508","T","C",30,6,36,0,25,1,26,0,0.0384615384615385,0.166666666666667,0.887096774193548,-0.128205128205128
"Chr08","11413513","A","G",9,30,39,0,2,27,29,0,0.931034482758621,0.769230769230769,0.161764705882353,0.161803713527851
"Chr08","11900377","C","T",21,17,38,116,16,20,36,1,0.555555555555556,0.447368421052632,0.5,0.108187134502924
"Chr08","13253554","T","G",73,62,135,160,87,68,155,160,0.438709677419355,0.459259259259259,0.551724137931034,-0.0205495818399044
"Chr08","13976448","T","C",36,32,68,148,41,35,76,148,0.460526315789474,0.470588235294118,0.534722222222222,-0.010061919504644
"Chr08","14921641","T","A",14,5,19,43,11,0,11,49,0,0.263157894736842,0.833333333333333,-0.263157894736842
"Chr08","15353833","G","A",3,2,5,16,3,7,10,33,0.7,0.4,0.4,0.3
"Chr08","15449409","G","A",65,38,103,135,82,61,143,150,0.426573426573427,0.368932038834951,0.597560975609756,0.0576413877384751
"Chr08","15449491","G","C",60,31,91,160,56,62,118,160,0.525423728813559,0.340659340659341,0.555023923444976,0.184764388154219
"Chr08","15952701","T","C",22,17,39,61,24,13,37,30,0.351351351351351,0.435897435897436,0.605263157894737,-0.0845460845460845
"Chr08","16019935","A","C",48,40,88,143,50,31,81,143,0.382716049382716,0.454545454545455,0.579881656804734,-0.0718294051627385
"Chr08","16918633","C","T",54,29,83,141,59,56,115,141,0.48695652173913,0.349397590361446,0.570707070707071,0.137558931377685
"Chr08","17029717","T","C",9,16,25,5,7,26,33,33,0.787878787878788,0.64,0.275862068965517,0.147878787878788
"Chr08","17711938","A","G",1,16,17,60,6,15,21,40,0.714285714285714,0.941176470588235,0.184210526315789,-0.226890756302521
"Chr08","17711953","G","A",1,18,19,61,11,12,23,96,0.521739130434783,0.947368421052632,0.285714285714286,-0.425629290617849
"Chr08","17836600","G","A",21,27,48,160,30,39,69,160,0.565217391304348,0.5625,0.435897435897436,0.00271739130434778
"Chr08","19900274","A","T",33,36,69,140,31,39,70,140,0.557142857142857,0.521739130434783,0.460431654676259,0.0354037267080746
"Chr08","20361547","A","T",51,52,103,160,69,61,130,160,0.469230769230769,0.504854368932039,0.515021459227468,-0.0356235997012696
"Chr08","20563987","G","A",5,16,21,0,14,16,30,53,0.533333333333333,0.761904761904762,0.372549019607843,-0.228571428571429
"Chr08","20807702","G","A",9,2,11,1,12,3,15,18,0.2,0.181818181818182,0.807692307692308,0.0181818181818182
"Chr08","22255241","C","T",18,26,44,160,21,28,49,160,0.571428571428571,0.590909090909091,0.419354838709677,-0.0194805194805195
"Chr08","22753573","A","T",40,35,75,141,45,29,74,141,0.391891891891892,0.466666666666667,0.570469798657718,-0.0747747747747748
"Chr08","23097970","A","G",27,29,56,146,28,23,51,146,0.450980392156863,0.517857142857143,0.514018691588785,-0.0668767507002802
"Chr08","24464678","A","C",56,38,94,139,67,51,118,139,0.432203389830508,0.404255319148936,0.580188679245283,0.0279480706815723
"Chr08","24673144","G","C",32,19,51,143,21,26,47,143,0.553191489361702,0.372549019607843,0.540816326530612,0.180642469753859
"Chr08","25473314","G","A",49,48,97,74,38,40,78,52,0.512820512820513,0.494845360824742,0.497142857142857,0.0179751519957705
"Chr08","29350786","C","T",29,35,64,160,46,45,91,160,0.494505494505495,0.546875,0.483870967741935,-0.0523695054945055
"Chr08","29420440","C","T",35,34,69,140,41,42,83,140,0.506024096385542,0.492753623188406,0.5,0.0132704731971363
"Chr08","30082606","C","T",6,3,9,18,5,2,7,8,0.285714285714286,0.333333333333333,0.6875,-0.0476190476190476
"Chr08","31014091","A","G",2,1,3,22,1,9,10,19,0.9,0.333333333333333,0.230769230769231,0.566666666666667
"Chr08","32092891","C","A",51,60,111,140,52,53,105,140,0.504761904761905,0.540540540540541,0.476851851851852,-0.0357786357786358
"Chr08","35166525","A","C",71,63,134,150,73,77,150,150,0.513333333333333,0.470149253731343,0.507042253521127,0.04318407960199
"Chr08","35858579","C","A",1,6,7,1,5,15,20,48,0.75,0.857142857142857,0.222222222222222,-0.107142857142857
"Chr08","35858588","C","T",1,6,7,2,6,14,20,65,0.7,0.857142857142857,0.259259259259259,-0.157142857142857
"Chr08","35858780","C","T",17,6,23,23,16,11,27,102,0.407407407407407,0.260869565217391,0.66,0.146537842190016
"Chr08","35946166","T","G",58,67,125,139,47,54,101,139,0.534653465346535,0.536,0.464601769911504,-0.00134653465346535
"Chr08","35989917","G","A",55,61,116,160,67,70,137,160,0.510948905109489,0.525862068965517,0.482213438735178,-0.0149131638560281
"Chr08","37031877","A","T",70,72,142,160,96,98,194,160,0.505154639175258,0.507042253521127,0.494047619047619,-0.00188761434586904
"Chr08","38069631","C","T",78,63,141,160,69,77,146,160,0.527397260273973,0.446808510638298,0.51219512195122,0.0805887496356748
"Chr08","38492928","T","C",31,19,50,160,25,34,59,160,0.576271186440678,0.38,0.513761467889908,0.196271186440678
"Chr08","38567722","G","C",4,7,11,22,6,14,20,20,0.7,0.636363636363636,0.32258064516129,0.0636363636363636
"Chr08","38908157","T","C",16,18,34,48,20,24,44,0,0.545454545454545,0.529411764705882,0.461538461538462,0.0160427807486631
"Chr08","38987799","T","C",25,5,30,59,34,8,42,76,0.19047619047619,0.166666666666667,0.819444444444444,0.0238095238095238
"Chr08","40871113","C","A",48,46,94,157,49,40,89,157,0.449438202247191,0.48936170212766,0.530054644808743,-0.0399234998804686
"Chr08","41339450","G","A",22,5,27,0,26,25,51,135,0.490196078431373,0.185185185185185,0.615384615384615,0.305010893246187
"Chr08","41634136","A","G",70,52,122,160,77,78,155,160,0.503225806451613,0.426229508196721,0.530685920577617,0.0769962982548916
"Chr08","41719209","C","T",2,11,13,30,8,19,27,16,0.703703703703704,0.846153846153846,0.25,-0.142450142450142
"Chr08","42433388","T","G",13,4,17,19,20,7,27,3,0.259259259259259,0.235294117647059,0.75,0.0239651416122004
"Chr08","43020866","A","T",3,2,5,25,4,2,6,3,0.333333333333333,0.4,0.636363636363636,-0.0666666666666667
"Chr08","43294669","G","A",8,7,15,29,14,5,19,1,0.263157894736842,0.466666666666667,0.647058823529412,-0.203508771929825
"Chr08","44385055","G","A",49,56,105,160,62,63,125,160,0.504,0.533333333333333,0.482608695652174,-0.0293333333333333
"Chr08","44449959","G","A",13,6,19,70,7,10,17,26,0.588235294117647,0.315789473684211,0.555555555555556,0.272445820433437
"Chr08","44466995","G","A",2,5,7,35,1,3,4,12,0.75,0.714285714285714,0.272727272727273,0.0357142857142857
"Chr08","44488324","G","A",3,1,4,9,8,0,8,37,0,0.25,0.916666666666667,-0.25
"Chr08","44815476","G","A",18,1,19,51,19,10,29,0,0.344827586206897,0.0526315789473684,0.770833333333333,0.292196007259528
"Chr08","45747442","G","A",16,31,47,2,25,23,48,77,0.479166666666667,0.659574468085106,0.431578947368421,-0.18040780141844
"Chr08","45747499","G","T",16,37,53,0,30,20,50,160,0.4,0.69811320754717,0.446601941747573,-0.29811320754717
"Chr08","45990605","T","C",21,19,40,135,26,28,54,134,0.518518518518518,0.475,0.5,0.0435185185185185
"Chr08","46393999","A","T",4,0,4,25,10,2,12,30,0.166666666666667,0,0.875,0.166666666666667
"Chr08","46887477","A","G",2,14,16,29,5,22,27,5,0.814814814814815,0.875,0.162790697674419,-0.0601851851851852
"Chr08","47113016","C","T",18,12,30,45,29,29,58,139,0.5,0.4,0.534090909090909,0.1
"Chr08","47113059","T","C",5,5,10,9,20,11,31,59,0.354838709677419,0.5,0.609756097560976,-0.145161290322581
"Chr08","47113061","G","A",6,4,10,2,21,9,30,0,0.3,0.4,0.675,-0.1
"Chr08","47114752","C","T",3,4,7,9,5,5,10,0,0.5,0.571428571428571,0.470588235294118,-0.0714285714285714
"Chr08","47124210","A","G",21,0,21,87,28,1,29,107,0.0344827586206897,0,0.98,0.0344827586206897
"Chr08","47166392","T","A",9,3,12,13,13,10,23,10,0.434782608695652,0.25,0.628571428571429,0.184782608695652
"Chr08","47184582","G","T",7,7,14,0,11,14,25,1,0.56,0.5,0.461538461538462,0.0600000000000001
"Chr08","47616957","C","A",58,55,113,142,74,74,148,142,0.5,0.486725663716814,0.505747126436782,0.0132743362831859
"Chr08","47743194","C","G",6,11,17,10,13,6,19,1,0.315789473684211,0.647058823529412,0.527777777777778,-0.331269349845201
"Chr08","47878897","A","G",11,7,18,1,12,14,26,10,0.538461538461538,0.388888888888889,0.522727272727273,0.14957264957265
"Chr08","48080909","C","T",50,47,97,140,76,86,162,140,0.530864197530864,0.484536082474227,0.486486486486487,0.0463281150566374
"Chr08","48661215","G","A",32,39,71,104,53,44,97,139,0.45360824742268,0.549295774647887,0.505952380952381,-0.095687527225207
"Chr08","48729868","T","C",5,7,12,26,15,14,29,46,0.482758620689655,0.583333333333333,0.48780487804878,-0.100574712643678
"Chr08","48751369","A","C",26,31,57,36,37,37,74,25,0.5,0.543859649122807,0.480916030534351,-0.043859649122807
"Chr08","48853869","C","T",47,46,93,141,59,67,126,141,0.531746031746032,0.494623655913978,0.484018264840183,0.0371223758320532
"Chr08","49141252","G","A",6,10,16,6,5,4,9,0,0.444444444444444,0.625,0.44,-0.180555555555556
"Chr08","49413060","G","T",7,9,16,24,12,2,14,38,0.142857142857143,0.5625,0.633333333333333,-0.419642857142857
"Chr08","49456590","G","A",6,13,19,86,8,10,18,82,0.555555555555556,0.684210526315789,0.378378378378378,-0.128654970760234
"Chr08","50094572","C","T",14,19,33,62,32,28,60,140,0.466666666666667,0.575757575757576,0.494623655913978,-0.109090909090909
"Chr08","50229516","G","A",45,39,84,160,45,53,98,160,0.540816326530612,0.464285714285714,0.494505494505495,0.076530612244898
"Chr08","51147647","C","T",0,1,1,9,2,1,3,26,0.333333333333333,1,0.5,-0.666666666666667
"Chr08","51175927","G","A",45,35,80,140,38,48,86,140,0.558139534883721,0.4375,0.5,0.120639534883721
"Chr08","51175955","G","C",37,30,67,140,34,41,75,140,0.546666666666667,0.447761194029851,0.5,0.0989054726368159
"Chr08","51204655","G","A",11,4,15,1,18,13,31,140,0.419354838709677,0.266666666666667,0.630434782608696,0.152688172043011
"Chr08","51263923","A","G",41,28,69,141,41,40,81,141,0.493827160493827,0.405797101449275,0.546666666666667,0.0880300590445517
"Chr08","51280289","A","T",66,43,109,141,72,65,137,141,0.474452554744526,0.394495412844037,0.560975609756098,0.0799571419004888
"Chr08","51537740","T","C",0,17,17,61,1,21,22,58,0.954545454545455,1,0.0256410256410256,-0.0454545454545454
"Chr08","51539898","A","T",8,4,12,4,6,9,15,90,0.6,0.333333333333333,0.518518518518518,0.266666666666667
"Chr08","51792676","C","A",8,6,14,31,9,16,25,1,0.64,0.428571428571429,0.435897435897436,0.211428571428571
"Chr08","51998409","G","A",NA,NA,NA,NA,1,3,4,3,0.75,NA,NA,NA
"Chr08","52262271","C","T",21,23,44,55,23,21,44,144,0.477272727272727,0.522727272727273,0.5,-0.0454545454545454
"Chr08","52266692","G","C",39,32,71,160,48,48,96,160,0.5,0.450704225352113,0.520958083832335,0.0492957746478873
"Chr08","52266713","G","A",37,30,67,147,49,45,94,147,0.478723404255319,0.447761194029851,0.53416149068323,0.0309622102254684
"Chr08","52440727","C","G",9,17,26,143,16,17,33,143,0.515151515151515,0.653846153846154,0.423728813559322,-0.138694638694639
"Chr08","52815754","G","T",4,3,7,39,2,1,3,8,0.333333333333333,0.428571428571429,0.6,-0.0952380952380952
"Chr08","53450217","G","A",10,13,23,26,21,18,39,84,0.461538461538462,0.565217391304348,0.5,-0.103678929765886
"Chr08","53507710","C","G",88,68,156,160,77,80,157,160,0.509554140127389,0.435897435897436,0.527156549520767,0.0736567042299526
"Chr08","53885902","T","C",27,64,91,98,48,46,94,144,0.48936170212766,0.703296703296703,0.405405405405405,-0.213935001169044
"Chr08","53994155","T","C",17,28,45,32,26,26,52,134,0.5,0.622222222222222,0.443298969072165,-0.122222222222222
"Chr08","54067570","C","T",11,4,15,16,13,2,15,7,0.133333333333333,0.266666666666667,0.8,-0.133333333333333
"Chr08","54379878","G","A",33,23,56,0,30,25,55,84,0.454545454545455,0.410714285714286,0.567567567567568,0.0438311688311688
"Chr08","54380828","G","A",11,28,39,0,24,26,50,36,0.52,0.717948717948718,0.393258426966292,-0.197948717948718
"Chr08","55341662","G","A",13,4,17,15,8,11,19,58,0.578947368421053,0.235294117647059,0.583333333333333,0.343653250773994
"Chr08","55384834","G","A",32,42,74,153,37,27,64,135,0.421875,0.567567567567568,0.5,-0.145692567567568
"Chr08","57137039","T","G",85,68,153,160,113,102,215,160,0.474418604651163,0.444444444444444,0.53804347826087,0.0299741602067184
"Chr09","314749","T","C",7,4,11,14,6,9,15,0,0.6,0.363636363636364,0.5,0.236363636363636
"Chr09","895698","G","A",20,10,30,46,22,9,31,6,0.290322580645161,0.333333333333333,0.688524590163934,-0.043010752688172
"Chr09","895728","G","T",20,10,30,17,22,8,30,2,0.266666666666667,0.333333333333333,0.7,-0.0666666666666667
"Chr09","1470098","G","T",2,10,12,31,1,13,14,35,0.928571428571429,0.833333333333333,0.115384615384615,0.0952380952380952
"Chr09","2414348","G","A",15,6,21,0,18,11,29,0,0.379310344827586,0.285714285714286,0.66,0.0935960591133005
"Chr09","3545184","T","G",109,97,206,160,125,143,268,160,0.533582089552239,0.470873786407767,0.493670886075949,0.0627083031444718
"Chr09","3871629","T","A",84,83,167,141,67,134,201,141,0.666666666666667,0.497005988023952,0.410326086956522,0.169660678642715
"Chr09","4788611","G","C",59,69,128,140,68,81,149,140,0.543624161073825,0.5390625,0.458483754512635,0.0045616610738255
"Chr09","7660009","A","G",0,2,2,3,NA,NA,NA,NA,NA,1,NA,NA
"Chr09","7703861","A","C",4,3,7,16,11,6,17,35,0.352941176470588,0.428571428571429,0.625,-0.0756302521008403
"Chr09","9426166","G","A",21,36,57,125,26,43,69,160,0.623188405797101,0.631578947368421,0.373015873015873,-0.00839054157131958
"Chr09","9571949","G","C",6,7,13,42,20,7,27,42,0.259259259259259,0.538461538461538,0.65,-0.279202279202279
"Chr09","9735379","C","T",54,40,94,139,47,58,105,139,0.552380952380952,0.425531914893617,0.507537688442211,0.126849037487335
"Chr09","10824020","C","T",36,41,77,160,51,40,91,160,0.43956043956044,0.532467532467532,0.517857142857143,-0.0929070929070929
"Chr09","10949030","T","C",62,66,128,140,64,90,154,140,0.584415584415584,0.515625,0.446808510638298,0.0687905844155844
"Chr09","11197179","A","G",37,50,87,141,46,72,118,141,0.610169491525424,0.574712643678161,0.404878048780488,0.0354568478472629
"Chr09","11935014","C","T",61,61,122,160,73,75,148,160,0.506756756756757,0.5,0.496296296296296,0.0067567567567568
"Chr09","12268244","G","A",5,31,36,59,15,11,26,112,0.423076923076923,0.861111111111111,0.32258064516129,-0.438034188034188
"Chr09","12907880","G","A",32,41,73,145,51,51,102,145,0.5,0.561643835616438,0.474285714285714,-0.0616438356164384
"Chr09","13618057","T","G",20,18,38,78,35,32,67,90,0.477611940298507,0.473684210526316,0.523809523809524,0.00392772977219169
"Chr09","13622886","G","A",21,21,42,87,22,27,49,52,0.551020408163265,0.5,0.472527472527473,0.0510204081632653
"Chr09","14346716","T","C",11,23,34,12,8,21,29,14,0.724137931034483,0.676470588235294,0.301587301587302,0.0476673427991886
"Chr09","15789532","G","A",45,27,72,160,56,49,105,160,0.466666666666667,0.375,0.570621468926554,0.0916666666666667
"Chr09","17844181","G","T",14,18,32,142,10,20,30,137,0.666666666666667,0.5625,0.387096774193548,0.104166666666667
"Chr09","18356244","C","T",18,14,32,142,22,23,45,142,0.511111111111111,0.4375,0.519480519480519,0.0736111111111111
"Chr09","18486222","T","G",44,39,83,160,40,44,84,160,0.523809523809524,0.469879518072289,0.502994011976048,0.0539300057372347
"Chr09","19489809","C","A",55,53,108,141,33,57,90,141,0.633333333333333,0.490740740740741,0.444444444444444,0.142592592592593
"Chr09","20556711","G","A",20,9,29,77,9,16,25,107,0.64,0.310344827586207,0.537037037037037,0.329655172413793
"Chr09","20948294","A","G",46,46,92,143,51,58,109,143,0.532110091743119,0.5,0.482587064676617,0.0321100917431193
"Chr09","21703256","C","T",24,9,33,81,22,13,35,142,0.371428571428571,0.272727272727273,0.676470588235294,0.0987012987012987
"Chr09","22544248","G","T",36,30,66,160,33,38,71,160,0.535211267605634,0.454545454545455,0.503649635036496,0.0806658130601792
"Chr09","23741937","G","T",15,4,19,86,17,27,44,142,0.613636363636364,0.210526315789474,0.507936507936508,0.40311004784689
"Chr09","23862779","T","A",55,65,120,160,61,80,141,160,0.567375886524823,0.541666666666667,0.444444444444444,0.0257092198581561
"Chr09","23971404","G","C",51,37,88,160,51,53,104,160,0.509615384615385,0.420454545454545,0.53125,0.0891608391608391
"Chr09","24196581","G","A",12,2,14,60,17,4,21,1,0.19047619047619,0.142857142857143,0.828571428571429,0.0476190476190476
"Chr09","24196601","C","A",13,3,16,55,15,4,19,2,0.210526315789474,0.1875,0.8,0.0230263157894737
"Chr09","24224326","T","C",65,59,124,160,73,74,147,160,0.503401360544218,0.475806451612903,0.509225092250922,0.0275949089313144
"Chr09","24228096","C","T",0,13,13,61,0,24,24,94,1,1,0,0
"Chr09","24228117","G","A",0,10,10,45,0,21,21,78,1,1,0,0
"Chr09","24262071","T","A",77,71,148,62,66,78,144,99,0.541666666666667,0.47972972972973,0.48972602739726,0.0619369369369369
"Chr09","24321058","T","C",23,27,50,109,19,37,56,80,0.660714285714286,0.54,0.39622641509434,0.120714285714286
"Chr09","24355704","T","A",73,76,149,141,72,76,148,141,0.513513513513513,0.51006711409396,0.488215488215488,0.00344639941955371
"Chr09","24355985","C","G",45,56,101,139,49,49,98,139,0.5,0.554455445544555,0.472361809045226,-0.0544554455445545
"Chr09","24415379","C","T",37,42,79,160,44,32,76,160,0.421052631578947,0.531645569620253,0.52258064516129,-0.110592938041306
"Chr09","24416108","G","A",54,59,113,160,65,42,107,160,0.392523364485981,0.52212389380531,0.540909090909091,-0.129600529319328
"Chr09","24445553","T","G",79,126,205,137,66,134,200,137,0.67,0.614634146341463,0.358024691358025,0.0553658536585366
"Chr09","24509412","T","G",68,96,164,134,82,111,193,134,0.575129533678757,0.585365853658537,0.420168067226891,-0.01023631997978
"Chr09","24603364","C","T",32,26,58,111,54,39,93,65,0.419354838709677,0.448275862068966,0.56953642384106,-0.0289210233592881
"Chr09","24739187","G","A",8,13,21,1,7,11,18,10,0.611111111111111,0.619047619047619,0.384615384615385,-0.00793650793650791
"Chr09","24762086","C","T",59,55,114,51,83,65,148,160,0.439189189189189,0.482456140350877,0.541984732824427,-0.043266951161688
"Chr09","24793214","T","C",25,30,55,160,24,29,53,160,0.547169811320755,0.545454545454545,0.453703703703704,0.00171526586620929
"Chr09","24891427","C","T",17,2,19,52,19,4,23,1,0.173913043478261,0.105263157894737,0.857142857142857,0.068649885583524
"Chr09","24891535","C","T",11,17,28,53,18,23,41,104,0.560975609756098,0.607142857142857,0.420289855072464,-0.0461672473867595
"Chr09","24966022","A","G",16,19,35,35,37,9,46,88,0.195652173913043,0.542857142857143,0.654320987654321,-0.347204968944099
"Chr09","24966159","A","G",25,30,55,0,25,39,64,67,0.609375,0.545454545454545,0.420168067226891,0.0639204545454546
"Chr09","24975440","C","T",22,32,54,11,37,42,79,116,0.531645569620253,0.592592592592593,0.443609022556391,-0.0609470229723394
"Chr09","24975456","C","T",21,29,50,57,38,39,77,138,0.506493506493506,0.58,0.464566929133858,-0.0735064935064935
"Chr09","24983227","G","A",31,40,71,0,27,22,49,137,0.448979591836735,0.563380281690141,0.483333333333333,-0.114400689853406
"Chr09","25041480","G","T",40,45,85,160,54,64,118,160,0.542372881355932,0.529411764705882,0.463054187192118,0.0129611166500498
"Chr09","25250950","G","A",51,76,127,160,59,58,117,130,0.495726495726496,0.598425196850394,0.450819672131148,-0.102698701123898
"Chr09","25250964","C","T",49,64,113,70,55,53,108,73,0.490740740740741,0.566371681415929,0.470588235294118,-0.0756309406751884
"Chr09","25250969","G","A",47,62,109,75,52,52,104,45,0.5,0.568807339449541,0.464788732394366,-0.0688073394495413
"Chr09","25250974","C","T",51,56,107,105,52,45,97,114,0.463917525773196,0.523364485981308,0.504901960784314,-0.0594469602081125
"Chr09","25488256","A","C",31,33,64,160,44,37,81,160,0.45679012345679,0.515625,0.517241379310345,-0.0588348765432099
"Chr09","25525815","A","G",22,15,37,144,26,6,32,99,0.1875,0.405405405405405,0.695652173913043,-0.217905405405405
"Chr09","25538087","G","A",38,35,73,146,52,45,97,146,0.463917525773196,0.479452054794521,0.529411764705882,-0.0155345290213246
"Chr09","25543782","A","C",47,49,96,135,68,66,134,144,0.492537313432836,0.510416666666667,0.5,-0.0178793532338308
"Chr09","25670127","G","T",50,41,91,140,57,63,120,140,0.525,0.450549450549451,0.507109004739337,0.0744505494505495
"Chr09","25670138","T","G",47,52,99,157,66,62,128,157,0.484375,0.525252525252525,0.497797356828194,-0.0408775252525253
"Chr09","25770002","C","T",82,72,154,136,85,67,152,136,0.440789473684211,0.467532467532468,0.545751633986928,-0.026742993848257
"Chr09","25936863","A","G",56,46,102,139,38,52,90,139,0.577777777777778,0.450980392156863,0.489583333333333,0.126797385620915
"Chr09","25936883","T","C",48,52,100,139,57,30,87,139,0.344827586206897,0.52,0.561497326203209,-0.175172413793103
"Chr09","25936898","G","A",41,46,87,142,53,26,79,142,0.329113924050633,0.528735632183908,0.566265060240964,-0.199621708133275
"Chr09","25977701","A","C",48,40,88,144,47,43,90,135,0.477777777777778,0.454545454545455,0.533707865168539,0.0232323232323233
"Chr09","25995248","C","T",14,17,31,128,17,11,28,0,0.392857142857143,0.548387096774194,0.525423728813559,-0.155529953917051
"Chr09","26004305","G","A",65,49,114,137,58,57,115,137,0.495652173913044,0.429824561403509,0.537117903930131,0.0658276125095347
"Chr09","26024844","G","A",28,4,32,40,20,11,31,42,0.354838709677419,0.125,0.761904761904762,0.229838709677419
"Chr09","26024871","G","T",28,1,29,108,18,11,29,66,0.379310344827586,0.0344827586206897,0.793103448275862,0.344827586206897
"Chr09","26024908","T","C",26,1,27,106,24,10,34,0,0.294117647058824,0.037037037037037,0.819672131147541,0.257080610021787
"Chr09","26146810","C","G",40,31,71,140,37,37,74,140,0.5,0.436619718309859,0.531034482758621,0.0633802816901409
"Chr09","26199885","C","T",41,39,80,137,52,36,88,60,0.409090909090909,0.4875,0.553571428571429,-0.0784090909090909
"Chr09","26228177","G","T",37,56,93,160,56,66,122,160,0.540983606557377,0.602150537634409,0.432558139534884,-0.0611669310770315
"Chr09","26228212","C","T",51,74,125,160,67,81,148,160,0.547297297297297,0.592,0.432234432234432,-0.0447027027027027
"Chr09","26228239","T","C",51,75,126,160,62,83,145,160,0.572413793103448,0.595238095238095,0.416974169741697,-0.0228243021346469
"Chr09","26228262","A","G",45,71,116,136,53,72,125,136,0.576,0.612068965517241,0.406639004149378,-0.0360689655172414
"Chr09","26381196","G","A",45,50,95,160,59,64,123,160,0.520325203252033,0.526315789473684,0.477064220183486,-0.00599058622165161
"Chr09","26388631","T","C",58,72,130,160,74,86,160,160,0.5375,0.553846153846154,0.455172413793103,-0.0163461538461539
"Chr09","26392679","C","G",42,41,83,160,58,63,121,160,0.520661157024793,0.493975903614458,0.490196078431373,0.0266852534103356
"Chr09","26424294","G","A",48,46,94,11,54,54,108,124,0.5,0.48936170212766,0.504950495049505,0.0106382978723404
"Chr09","26490412","T","C",18,39,57,139,32,28,60,139,0.466666666666667,0.684210526315789,0.427350427350427,-0.217543859649123
"Chr09","26497716","T","C",27,10,37,72,37,18,55,50,0.327272727272727,0.27027027027027,0.695652173913043,0.057002457002457
"Chr09","26497722","G","A",27,11,38,70,31,18,49,92,0.36734693877551,0.289473684210526,0.666666666666667,0.0778732545649839
"Chr09","26539351","C","T",38,30,68,141,46,76,122,141,0.622950819672131,0.441176470588235,0.442105263157895,0.181774349083896
"Chr09","26539399","C","T",31,38,69,143,60,82,142,143,0.577464788732394,0.550724637681159,0.431279620853081,0.026740151051235
"Chr09","26539436","A","G",35,35,70,160,52,60,112,160,0.535714285714286,0.5,0.478021978021978,0.0357142857142857
"Chr09","26545495","G","A",41,47,88,142,52,48,100,142,0.48,0.534090909090909,0.49468085106383,-0.0540909090909091
"Chr09","26545534","G","A",60,44,104,148,63,59,122,148,0.483606557377049,0.423076923076923,0.544247787610619,0.0605296343001261
"Chr09","26546914","C","T",60,73,133,137,73,75,148,137,0.506756756756757,0.548872180451128,0.473309608540925,-0.042115423694371
"Chr09","26546918","C","T",77,56,133,160,85,64,149,160,0.429530201342282,0.421052631578947,0.574468085106383,0.00847756976333452
"Chr09","26547291","G","A",40,47,87,160,52,58,110,160,0.527272727272727,0.540229885057471,0.467005076142132,-0.012957157784744
"Chr09","26600875","C","A",49,52,101,0,64,62,126,13,0.492063492063492,0.514851485148515,0.497797356828194,-0.0227879930850228
"Chr09","26694595","G","A",45,31,76,160,54,62,116,160,0.53448275862069,0.407894736842105,0.515625,0.126588021778584
"Chr09","26694606","G","A",47,31,78,142,53,66,119,142,0.554621848739496,0.397435897435897,0.50761421319797,0.157185951303598
"Chr09","26696010","G","C",16,15,31,145,16,19,35,145,0.542857142857143,0.483870967741935,0.484848484848485,0.0589861751152073
"Chr09","26703305","A","G",34,38,72,91,35,38,73,150,0.520547945205479,0.527777777777778,0.475862068965517,-0.00722983257229837
"Chr09","26833492","C","T",69,64,133,160,72,90,162,160,0.555555555555556,0.481203007518797,0.477966101694915,0.0743525480367586
"Chr09","26833645","C","G",62,48,110,160,59,70,129,160,0.542635658914729,0.436363636363636,0.506276150627615,0.106272022551092
"Chr09","26833908","C","T",73,115,188,160,76,139,215,160,0.646511627906977,0.611702127659574,0.369727047146402,0.0348095002474023
"Chr09","26873984","T","A",70,88,158,160,64,100,164,160,0.609756097560976,0.556962025316456,0.416149068322981,0.0527940722445199
"Chr09","26953033","A","G",37,49,86,147,33,51,84,147,0.607142857142857,0.569767441860465,0.411764705882353,0.037375415282392
"Chr09","26966003","G","A",70,71,141,160,80,71,151,160,0.470198675496689,0.50354609929078,0.513698630136986,-0.0333474237940913
"Chr09","26966080","T","A",66,78,144,145,72,63,135,145,0.466666666666667,0.541666666666667,0.494623655913978,-0.075
"Chr09","26971161","A","G",54,71,125,160,88,96,184,160,0.521739130434783,0.568,0.459546925566343,-0.0462608695652174
"Chr09","30728648","A","G",31,27,58,93,40,44,84,135,0.523809523809524,0.46551724137931,0.5,0.0582922824302135
"Chr09","30778749","G","T",52,52,104,125,69,66,135,140,0.488888888888889,0.5,0.506276150627615,-0.0111111111111111
"Chr09","30826707","T","C",10,6,16,54,18,20,38,147,0.526315789473684,0.375,0.518518518518518,0.151315789473684
"Chr09","30880950","G","A",21,35,56,78,21,17,38,0,0.447368421052632,0.625,0.446808510638298,-0.177631578947368
"Chr09","31022325","A","G",51,42,93,139,48,49,97,139,0.505154639175258,0.451612903225806,0.521052631578947,0.0535417359494513
"Chr09","31417646","T","C",10,11,21,61,22,3,25,68,0.12,0.523809523809524,0.695652173913043,-0.403809523809524
"Chr09","32315142","T","C",7,2,9,2,4,2,6,1,0.333333333333333,0.222222222222222,0.733333333333333,0.111111111111111
"Chr09","32638941","G","C",30,31,61,103,33,40,73,121,0.547945205479452,0.508196721311475,0.470149253731343,0.0397484841679766
"Chr09","32755678","C","T",28,33,61,160,42,48,90,160,0.533333333333333,0.540983606557377,0.463576158940397,-0.00765027322404377
"Chr09","33621261","A","T",67,74,141,140,90,89,179,140,0.497206703910615,0.524822695035461,0.490625,-0.0276159911248465
"Chr09","33796050","G","A",55,49,104,160,65,57,122,160,0.467213114754098,0.471153846153846,0.530973451327434,-0.00394073139974777
"Chr09","33977372","G","T",47,38,85,143,51,68,119,143,0.571428571428571,0.447058823529412,0.480392156862745,0.12436974789916
"Chr09","34555150","C","T",5,32,37,80,3,43,46,126,0.934782608695652,0.864864864864865,0.0963855421686747,0.0699177438307873
"Chr09","34719416","C","T",20,8,28,42,21,14,35,70,0.4,0.285714285714286,0.650793650793651,0.114285714285714
"Chr09","34719436","G","A",11,18,29,69,14,20,34,85,0.588235294117647,0.620689655172414,0.396825396825397,-0.0324543610547667
"Chr09","34719441","G","A",23,7,30,23,22,14,36,49,0.388888888888889,0.233333333333333,0.681818181818182,0.155555555555556
"Chr09","34719447","C","G",11,19,30,66,16,20,36,96,0.555555555555556,0.633333333333333,0.409090909090909,-0.0777777777777777
"Chr09","34719500","C","T",12,21,33,39,18,18,36,124,0.5,0.636363636363636,0.434782608695652,-0.136363636363636
"Chr09","34719505","G","A",12,21,33,40,17,18,35,101,0.514285714285714,0.636363636363636,0.426470588235294,-0.122077922077922
"Chr09","35056342","A","C",16,8,24,105,20,4,24,0,0.166666666666667,0.333333333333333,0.75,-0.166666666666667
"Chr09","35875787","C","T",21,2,23,38,12,6,18,22,0.333333333333333,0.0869565217391304,0.804878048780488,0.246376811594203
"Chr09","37190480","C","G",59,51,110,160,60,74,134,160,0.552238805970149,0.463636363636364,0.487704918032787,0.0886024423337857
"Chr09","37506799","C","T",25,52,77,14,31,56,87,42,0.64367816091954,0.675324675324675,0.341463414634146,-0.0316465144051351
"Chr09","37868234","C","T",49,33,82,160,48,23,71,160,0.323943661971831,0.402439024390244,0.633986928104575,-0.0784953624184129
"Chr09","40194660","G","A",17,6,23,33,20,5,25,61,0.2,0.260869565217391,0.770833333333333,-0.0608695652173913
"Chr09","41535391","T","A",82,55,137,160,63,61,124,160,0.491935483870968,0.401459854014599,0.555555555555556,0.0904756298563692
"Chr09","42130199","C","G",49,36,85,140,46,46,92,140,0.5,0.423529411764706,0.536723163841808,0.0764705882352941
"Chr09","44272022","G","A",36,27,63,160,42,41,83,160,0.493975903614458,0.428571428571429,0.534246575342466,0.0654044750430293
"Chr09","44569315","C","T",20,23,43,160,33,30,63,160,0.476190476190476,0.534883720930233,0.5,-0.0586932447397563
"Chr09","45105035","C","T",11,19,30,0,20,20,40,42,0.5,0.633333333333333,0.442857142857143,-0.133333333333333
"Chr09","45394060","G","A",9,9,18,121,10,7,17,124,0.411764705882353,0.5,0.542857142857143,-0.0882352941176471
"Chr09","47039554","A","G",26,21,47,142,17,29,46,142,0.630434782608696,0.446808510638298,0.462365591397849,0.183626271970398
"Chr09","47661853","A","C",15,12,27,110,6,5,11,25,0.454545454545455,0.444444444444444,0.552631578947368,0.0101010101010101
"Chr09","48245624","G","A",52,43,95,160,53,56,109,160,0.513761467889908,0.452631578947368,0.514705882352941,0.0611298889425398
"Chr09","49388857","T","C",38,38,76,147,49,47,96,147,0.489583333333333,0.5,0.505813953488372,-0.0104166666666667
"Chr09","49389207","T","G",44,56,100,142,48,73,121,142,0.603305785123967,0.56,0.416289592760181,0.0433057851239669
"Chr09","49389636","G","T",51,54,105,139,59,65,124,139,0.524193548387097,0.514285714285714,0.480349344978166,0.00990783410138252
"Chr09","49389839","T","A",57,46,103,139,72,59,131,139,0.450381679389313,0.446601941747573,0.551282051282051,0.00377973764174011
"Chr09","49390114","T","C",33,45,78,154,46,46,92,154,0.5,0.576923076923077,0.464705882352941,-0.0769230769230769
"Chr09","49390205","T","C",62,60,122,160,99,83,182,160,0.456043956043956,0.491803278688525,0.529605263157895,-0.0357593226445685
"Chr09","49391302","G","T",76,70,146,160,83,111,194,160,0.572164948453608,0.479452054794521,0.467647058823529,0.0927128936590877
"Chr09","49391446","G","A",78,71,149,160,76,98,174,160,0.563218390804598,0.476510067114094,0.476780185758514,0.0867083236905037
"Chr09","49391604","C","T",46,49,95,160,55,70,125,160,0.56,0.515789473684211,0.459090909090909,0.0442105263157895
"Chr09","49391644","A","G",51,56,107,160,56,69,125,160,0.552,0.523364485981308,0.461206896551724,0.0286355140186917
"Chr09","49391661","A","G",52,47,99,139,54,60,114,139,0.526315789473684,0.474747474747475,0.497652582159624,0.0515683147262094
"Chr09","49391672","C","A",51,52,103,151,55,78,133,151,0.586466165413534,0.504854368932039,0.449152542372881,0.081611796481495
"Chr09","49391695","C","T",52,55,107,145,52,88,140,145,0.628571428571429,0.514018691588785,0.421052631578947,0.114552736982644
"Chr09","49391756","A","G",58,73,131,160,61,86,147,160,0.585034013605442,0.557251908396947,0.428057553956835,0.0277821052084956
"Chr09","49391787","G","A",48,58,106,160,50,72,122,160,0.590163934426229,0.547169811320755,0.429824561403509,0.0429941231054748
"Chr09","49391796","T","G",47,61,108,139,47,73,120,139,0.608333333333333,0.564814814814815,0.412280701754386,0.0435185185185185
"Chr09","49391913","A","G",19,22,41,160,13,22,35,160,0.628571428571429,0.536585365853659,0.421052631578947,0.09198606271777
"Chr09","49392933","G","A",27,23,50,142,25,24,49,142,0.489795918367347,0.46,0.525252525252525,0.0297959183673469
"Chr09","49393959","T","G",90,79,169,160,104,79,183,160,0.431693989071038,0.467455621301775,0.551136363636364,-0.0357616322307369
"Chr09","49394952","A","T",73,89,162,139,79,94,173,139,0.543352601156069,0.549382716049383,0.453731343283582,-0.0060301148933134
"Chr09","49395124","G","A",77,107,184,136,109,126,235,136,0.536170212765957,0.581521739130435,0.443914081145585,-0.0453515263644774
"Chr09","49395718","T","C",83,77,160,160,108,94,202,160,0.465346534653465,0.48125,0.527624309392265,-0.0159034653465346
"Chr09","49395981","C","T",70,90,160,136,88,87,175,136,0.497142857142857,0.5625,0.471641791044776,-0.0653571428571428
"Chr09","49396448","T","C",60,60,120,143,83,96,179,143,0.536312849162011,0.5,0.478260869565217,0.0363128491620112
"Chr09","49396600","G","A",47,56,103,160,61,69,130,160,0.530769230769231,0.543689320388349,0.463519313304721,-0.0129200896191187
"Chr09","49396604","C","A",61,52,113,160,77,68,145,160,0.468965517241379,0.460176991150442,0.534883720930233,0.00878852609093683
"Chr09","49396692","C","T",58,67,125,147,71,80,151,147,0.529801324503311,0.536,0.467391304347826,-0.00619867549668873
"Chr09","49396782","C","T",67,80,147,160,98,73,171,160,0.426900584795322,0.54421768707483,0.518867924528302,-0.117317102279508
"Chr09","49396866","C","T",74,106,180,160,128,114,242,160,0.471074380165289,0.588888888888889,0.478672985781991,-0.1178145087236
"Chr09","49396970","G","A",78,77,155,140,94,108,202,140,0.534653465346535,0.496774193548387,0.481792717086835,0.0378792717981476
"Chr09","49397013","T","C",67,60,127,160,87,92,179,160,0.513966480446927,0.47244094488189,0.503267973856209,0.0415255355650376
"Chr09","49397117","C","T",66,52,118,146,73,66,139,146,0.474820143884892,0.440677966101695,0.540856031128405,0.0341421777831972
"Chr09","49397162","C","A",53,51,104,144,61,53,114,144,0.464912280701754,0.490384615384615,0.522935779816514,-0.025472334682861
"Chr09","49397994","T","C",57,29,86,141,67,31,98,141,0.316326530612245,0.337209302325581,0.673913043478261,-0.0208827717133365
"Chr09","49398470","T","C",49,37,86,140,57,48,105,140,0.457142857142857,0.430232558139535,0.554973821989529,0.0269102990033223
"Chr09","49398701","T","C",45,45,90,160,49,62,111,160,0.558558558558559,0.5,0.467661691542289,0.0585585585585585
"Chr09","49399257","A","G",78,50,128,160,60,68,128,160,0.53125,0.390625,0.5390625,0.140625
"Chr09","49399334","T","C",63,26,89,160,57,56,113,160,0.495575221238938,0.292134831460674,0.594059405940594,0.203440389778264
"Chr09","49399354","C","T",56,29,85,139,58,61,119,139,0.512605042016807,0.341176470588235,0.558823529411765,0.171428571428571
"Chr09","49399526","A","G",68,46,114,160,68,41,109,160,0.376146788990826,0.403508771929825,0.609865470852018,-0.0273619829389988
"Chr09","49400256","G","A",61,66,127,160,75,76,151,160,0.503311258278146,0.519685039370079,0.489208633093525,-0.016373781091933
"Chr09","49401509","G","A",85,76,161,135,73,83,156,135,0.532051282051282,0.472049689440994,0.498422712933754,0.0600015926102883
"Chr09","49403053","A","C",77,96,173,136,93,83,176,136,0.471590909090909,0.554913294797688,0.487106017191977,-0.0833223857067787
"Chr09","49403089","T","A",74,88,162,141,77,84,161,141,0.521739130434783,0.54320987654321,0.46749226006192,-0.0214707461084273
"Chr09","49403254","G","A",66,65,131,137,84,103,187,137,0.550802139037433,0.49618320610687,0.471698113207547,0.0546189329305629
"Chr09","49403269","C","G",60,62,122,137,93,102,195,137,0.523076923076923,0.508196721311475,0.482649842271293,0.0148802017654477
"Chr09","49403343","T","C",50,51,101,145,85,69,154,145,0.448051948051948,0.504950495049505,0.529411764705882,-0.0568985469975569
"Chr09","49403376","T","C",32,40,72,140,58,57,115,140,0.495652173913044,0.555555555555556,0.481283422459893,-0.0599033816425121
"Chr09","49403454","A","G",50,55,105,142,61,86,147,142,0.585034013605442,0.523809523809524,0.44047619047619,0.0612244897959183
"Chr09","49403482","G","C",58,52,110,151,68,86,154,151,0.558441558441558,0.472727272727273,0.477272727272727,0.0857142857142857
"Chr09","49403735","G","A",49,40,89,160,86,82,168,160,0.488095238095238,0.449438202247191,0.525291828793774,0.0386570358480471
"Chr09","49403810","A","G",55,63,118,141,94,91,185,141,0.491891891891892,0.533898305084746,0.491749174917492,-0.0420064131928539
"Chr09","49403857","C","A",63,67,130,160,77,82,159,160,0.515723270440252,0.515384615384615,0.484429065743945,0.000338655055636239
"Chr09","49404061","A","G",28,24,52,160,48,31,79,160,0.392405063291139,0.461538461538462,0.580152671755725,-0.0691333982473223
"Chr09","49404092","C","T",26,20,46,160,45,25,70,160,0.357142857142857,0.434782608695652,0.612068965517241,-0.077639751552795
"Chr09","49404102","A","G",24,20,44,160,43,23,66,160,0.348484848484849,0.454545454545455,0.609090909090909,-0.106060606060606
"Chr09","49404130","A","G",23,17,40,160,38,25,63,160,0.396825396825397,0.425,0.592233009708738,-0.0281746031746032
"Chr09","49404428","T","C",9,1,10,3,17,9,26,149,0.346153846153846,0.1,0.722222222222222,0.246153846153846
"Chr09","49404871","C","T",37,36,73,160,56,46,102,160,0.450980392156863,0.493150684931507,0.531428571428571,-0.0421702927746441
"Chr09","49409590","C","T",8,15,23,148,12,12,24,148,0.5,0.652173913043478,0.425531914893617,-0.152173913043478
"Chr09","49483227","A","G",3,18,21,0,11,31,42,0,0.738095238095238,0.857142857142857,0.222222222222222,-0.119047619047619
"Chr09","50067242","C","T",14,15,29,0,23,21,44,83,0.477272727272727,0.517241379310345,0.506849315068493,-0.0399686520376176
"Chr09","50699956","T","C",2,17,19,38,3,20,23,55,0.869565217391304,0.894736842105263,0.119047619047619,-0.0251716247139588
"Chr09","51058981","T","G",NA,NA,NA,NA,1,0,1,1,0,NA,NA,NA
"Chr09","51217818","G","A",15,6,21,2,12,5,17,28,0.294117647058824,0.285714285714286,0.710526315789474,0.00840336134453784
"Chr09","51424510","C","T",52,35,87,160,75,75,150,160,0.5,0.402298850574713,0.535864978902954,0.0977011494252873
"Chr09","53345796","A","C",27,30,57,142,53,41,94,142,0.436170212765957,0.526315789473684,0.529801324503311,-0.0901455767077267
"Chr09","54995965","G","A",7,12,19,141,17,13,30,160,0.433333333333333,0.631578947368421,0.489795918367347,-0.198245614035088
"Chr09","57520570","C","A",58,57,115,160,92,86,178,160,0.48314606741573,0.495652173913044,0.511945392491468,-0.0125061064973132
"Chr09","58561285","A","G",32,28,60,109,31,30,61,22,0.491803278688525,0.466666666666667,0.520661157024793,0.0251366120218579
"Chr10","288655","A","C",65,79,144,160,82,102,184,160,0.554347826086957,0.548611111111111,0.448170731707317,0.00573671497584538
"Chr10","380719","G","A",15,25,40,40,12,32,44,0,0.727272727272727,0.625,0.321428571428571,0.102272727272727
"Chr10","380730","A","T",15,25,40,45,12,32,44,0,0.727272727272727,0.625,0.321428571428571,0.102272727272727
"Chr10","3240949","A","G",61,56,117,139,83,83,166,139,0.5,0.478632478632479,0.508833922261484,0.0213675213675213
"Chr10","4066891","C","G",85,77,162,136,107,85,192,136,0.442708333333333,0.475308641975309,0.542372881355932,-0.0326003086419753
"Chr10","4185323","G","A",38,32,70,160,28,42,70,160,0.6,0.457142857142857,0.471428571428571,0.142857142857143
"Chr10","4494984","C","A",42,45,87,160,45,53,98,160,0.540816326530612,0.517241379310345,0.47027027027027,0.0235749472202674
"Chr10","4818865","G","A",42,47,89,142,46,48,94,142,0.51063829787234,0.528089887640449,0.480874316939891,-0.017451589768109
"Chr10","4999295","C","T",31,21,52,157,37,30,67,157,0.447761194029851,0.403846153846154,0.571428571428571,0.0439150401836969
"Chr10","5081938","C","T",15,24,39,160,35,16,51,160,0.313725490196078,0.615384615384615,0.555555555555556,-0.301659125188537
"Chr10","5478755","C","T",38,37,75,160,48,42,90,160,0.466666666666667,0.493333333333333,0.521212121212121,-0.0266666666666667
"Chr10","5506097","G","A",12,16,28,26,19,16,35,142,0.457142857142857,0.571428571428571,0.492063492063492,-0.114285714285714
"Chr10","6012752","C","T",46,41,87,139,54,58,112,139,0.517857142857143,0.471264367816092,0.50251256281407,0.046592775041051
"Chr10","6013115","C","G",58,61,119,160,62,64,126,160,0.507936507936508,0.512605042016807,0.489795918367347,-0.00466853408029877
"Chr10","6014295","A","G",57,54,111,160,52,68,120,160,0.566666666666667,0.486486486486487,0.471861471861472,0.0801801801801801
"Chr10","6014731","C","T",30,39,69,139,57,42,99,139,0.424242424242424,0.565217391304348,0.517857142857143,-0.140974967061924
"Chr10","6015391","C","G",10,12,22,144,13,20,33,144,0.606060606060606,0.545454545454545,0.418181818181818,0.0606060606060607
"Chr10","6016940","G","A",22,15,37,160,26,32,58,160,0.551724137931034,0.405405405405405,0.505263157894737,0.146318732525629
"Chr10","6017146","C","T",29,40,69,139,37,51,88,139,0.579545454545455,0.579710144927536,0.420382165605096,-0.000164690382081667
"Chr10","6017185","T","C",31,40,71,160,37,54,91,160,0.593406593406593,0.563380281690141,0.419753086419753,0.0300263117164525
"Chr10","6017259","C","T",39,40,79,160,39,47,86,160,0.546511627906977,0.506329113924051,0.472727272727273,0.040182513982926
"Chr10","6017631","A","C",49,52,101,160,58,72,130,160,0.553846153846154,0.514851485148515,0.463203463203463,0.038994668697639
"Chr10","6017702","C","G",51,55,106,160,58,63,121,160,0.520661157024793,0.518867924528302,0.480176211453745,0.00179323249649155
"Chr10","6017987","A","G",75,62,137,138,84,75,159,138,0.471698113207547,0.452554744525547,0.537162162162162,0.0191433686819997
"Chr10","6019889","T","C",51,65,116,160,89,75,164,160,0.457317073170732,0.560344827586207,0.5,-0.103027754415475
"Chr10","6020207","C","A",64,60,124,138,84,64,148,138,0.432432432432432,0.483870967741935,0.544117647058823,-0.051438535309503
"Chr10","6022332","C","T",67,72,139,146,64,79,143,146,0.552447552447552,0.517985611510791,0.464539007092199,0.034461940936761
"Chr10","6022446","C","A",55,91,146,139,66,70,136,139,0.514705882352941,0.623287671232877,0.429078014184397,-0.108581788879936
"Chr10","6022476","C","T",59,85,144,142,83,92,175,142,0.525714285714286,0.590277777777778,0.445141065830721,-0.0645634920634921
"Chr10","6024035","G","C",39,41,80,141,58,51,109,141,0.467889908256881,0.5125,0.513227513227513,-0.0446100917431192
"Chr10","6024042","C","G",38,43,81,148,64,53,117,148,0.452991452991453,0.530864197530864,0.515151515151515,-0.0778727445394112
"Chr10","6024206","C","G",37,34,71,139,53,48,101,139,0.475247524752475,0.47887323943662,0.523255813953488,-0.00362571468414447
"Chr10","6024252","T","C",41,44,85,139,61,57,118,139,0.483050847457627,0.517647058823529,0.502463054187192,-0.0345962113659024
"Chr10","6024755","T","C",39,38,77,139,55,45,100,139,0.45,0.493506493506494,0.531073446327684,-0.0435064935064935
"Chr10","6024815","T","C",45,38,83,160,58,58,116,160,0.5,0.457831325301205,0.517587939698492,0.0421686746987952
"Chr10","6024832","C","G",46,34,80,145,59,60,119,145,0.504201680672269,0.425,0.527638190954774,0.0792016806722689
"Chr10","6024864","C","G",41,29,70,160,54,59,113,160,0.52212389380531,0.414285714285714,0.519125683060109,0.107838179519595
"Chr10","6024966","A","C",23,14,37,142,28,32,60,142,0.533333333333333,0.378378378378378,0.525773195876289,0.154954954954955
"Chr10","6025101","C","A",23,24,47,139,39,49,88,139,0.556818181818182,0.51063829787234,0.459259259259259,0.0461798839458414
"Chr10","6025193","A","T",33,29,62,142,47,40,87,142,0.459770114942529,0.467741935483871,0.536912751677852,-0.00797182054134221
"Chr10","6026241","C","T",19,18,37,160,29,36,65,160,0.553846153846154,0.486486486486487,0.470588235294118,0.0673596673596674
"Chr10","6026440","A","T",35,49,84,141,61,53,114,141,0.464912280701754,0.583333333333333,0.484848484848485,-0.118421052631579
"Chr10","6026492","A","T",33,51,84,160,61,52,113,160,0.460176991150442,0.607142857142857,0.477157360406091,-0.146965865992415
"Chr10","6026709","G","T",30,42,72,160,61,45,106,160,0.424528301886792,0.583333333333333,0.51123595505618,-0.158805031446541
"Chr10","6026720","A","G",24,40,64,142,58,45,103,142,0.436893203883495,0.625,0.491017964071856,-0.188106796116505
"Chr10","6026815","C","T",29,35,64,160,37,35,72,160,0.486111111111111,0.546875,0.485294117647059,-0.0607638888888889
"Chr10","6026863","T","C",39,47,86,143,40,49,89,143,0.550561797752809,0.546511627906977,0.451428571428571,0.00405016984583229
"Chr10","6027283","G","T",31,29,60,160,26,33,59,160,0.559322033898305,0.483333333333333,0.478991596638655,0.0759887005649717
"Chr10","6028197","C","T",37,41,78,160,43,34,77,160,0.441558441558442,0.525641025641026,0.516129032258065,-0.0840825840825841
"Chr10","6030931","T","C",44,53,97,141,52,79,131,141,0.603053435114504,0.54639175257732,0.421052631578947,0.0566616825371843
"Chr10","6031883","C","G",47,63,110,160,75,78,153,160,0.509803921568627,0.572727272727273,0.463878326996198,-0.0629233511586453
"Chr10","6031969","G","T",40,63,103,141,78,58,136,141,0.426470588235294,0.611650485436893,0.493723849372385,-0.185179897201599
"Chr10","6031983","C","T",45,65,110,160,78,66,144,160,0.458333333333333,0.590909090909091,0.484251968503937,-0.132575757575758
"Chr10","6032052","C","T",61,59,120,139,85,78,163,139,0.478527607361963,0.491666666666667,0.515901060070671,-0.0131390593047034
"Chr10","6032263","T","C",57,54,111,138,89,57,146,138,0.39041095890411,0.486486486486487,0.568093385214008,-0.0960755275823769
"Chr10","6033070","A","C",51,48,99,160,58,43,101,160,0.425742574257426,0.484848484848485,0.545,-0.0591059105910591
"Chr10","6033193","C","T",48,51,99,136,85,59,144,136,0.409722222222222,0.515151515151515,0.547325102880658,-0.105429292929293
"Chr10","6033232","A","G",50,49,99,160,77,56,133,160,0.421052631578947,0.494949494949495,0.547413793103448,-0.0738968633705476
"Chr10","6033376","T","C",69,66,135,160,83,71,154,160,0.461038961038961,0.488888888888889,0.525951557093426,-0.0278499278499278
"Chr10","6033404","A","G",55,63,118,143,71,59,130,143,0.453846153846154,0.533898305084746,0.508064516129032,-0.0800521512385919
"Chr10","6033441","C","A",56,56,112,160,65,70,135,160,0.518518518518518,0.5,0.489878542510121,0.0185185185185185
"Chr10","6033452","G","C",54,52,106,143,56,76,132,143,0.575757575757576,0.490566037735849,0.46218487394958,0.0851915380217267
"Chr10","6033549","G","C",67,47,114,154,61,70,131,154,0.534351145038168,0.412280701754386,0.522448979591837,0.122070443283782
"Chr10","6037854","T","C",39,68,107,160,59,84,143,160,0.587412587412587,0.635514018691589,0.392,-0.0481014312790013
"Chr10","6037861","G","C",40,71,111,137,60,79,139,137,0.568345323741007,0.63963963963964,0.4,-0.0712943158986324
"Chr10","6037881","C","T",45,65,110,143,62,83,145,143,0.572413793103448,0.590909090909091,0.419607843137255,-0.0184952978056426
"Chr10","6037932","A","C",32,67,99,160,54,71,125,160,0.568,0.676767676767677,0.383928571428571,-0.108767676767677
"Chr10","6037951","C","G",39,79,118,147,60,79,139,147,0.568345323741007,0.669491525423729,0.385214007782101,-0.101146201682722
"Chr10","6037983","G","C",54,81,135,160,56,79,135,160,0.585185185185185,0.6,0.407407407407407,-0.0148148148148148
"Chr10","6038024","C","T",54,77,131,144,52,68,120,144,0.566666666666667,0.587786259541985,0.422310756972112,-0.0211195928753181
"Chr10","6038040","C","A",58,76,134,160,56,65,121,160,0.537190082644628,0.567164179104478,0.447058823529412,-0.0299740964598495
"Chr10","6038113","C","G",48,53,101,160,40,68,108,160,0.62962962962963,0.524752475247525,0.421052631578947,0.104877154382105
"Chr10","6038140","C","A",42,51,93,139,40,62,102,139,0.607843137254902,0.548387096774194,0.420512820512821,0.0594560404807084
"Chr10","6038156","T","C",47,57,104,160,49,79,128,160,0.6171875,0.548076923076923,0.413793103448276,0.0691105769230769
"Chr10","6038188","T","A",41,63,104,141,53,85,138,141,0.615942028985507,0.605769230769231,0.388429752066116,0.0101727982162765
"Chr10","6038224","C","A",45,69,114,147,54,86,140,147,0.614285714285714,0.605263157894737,0.389763779527559,0.00902255639097749
"Chr10","6038231","C","A",48,69,117,160,52,84,136,160,0.617647058823529,0.58974358974359,0.395256916996047,0.0279034690799397
"Chr10","6038241","C","A",49,72,121,139,61,90,151,139,0.596026490066225,0.59504132231405,0.404411764705882,0.000985167752175609
"Chr10","6038281","T","C",64,92,156,138,69,97,166,138,0.58433734939759,0.58974358974359,0.41304347826087,-0.00540624034599935
"Chr10","6038330","C","T",67,79,146,160,81,87,168,160,0.517857142857143,0.541095890410959,0.471337579617834,-0.0232387475538161
"Chr10","6038397","G","A",57,69,126,160,73,66,139,160,0.474820143884892,0.547619047619048,0.490566037735849,-0.0727989037341556
"Chr10","6038537","A","G",62,62,124,160,63,66,129,160,0.511627906976744,0.5,0.494071146245059,0.0116279069767442
"Chr10","6038633","A","G",54,49,103,160,58,56,114,160,0.491228070175439,0.475728155339806,0.516129032258065,0.0154999148356327
"Chr10","6038678","C","T",56,46,102,143,59,60,119,143,0.504201680672269,0.450980392156863,0.520361990950226,0.0532212885154061
"Chr10","6038762","G","A",63,62,125,139,80,79,159,139,0.49685534591195,0.496,0.503521126760563,0.00085534591194969
"Chr10","6038872","G","A",70,61,131,140,69,84,153,140,0.549019607843137,0.465648854961832,0.48943661971831,0.0833707528813052
"Chr10","6038940","T","A",64,70,134,148,83,79,162,148,0.487654320987654,0.522388059701492,0.496621621621622,-0.0347337387138382
"Chr10","6038954","T","C",58,65,123,159,79,87,166,159,0.524096385542169,0.528455284552846,0.474048442906574,-0.00435889901067688
"Chr10","6038996","C","G",54,68,122,139,93,77,170,139,0.452941176470588,0.557377049180328,0.503424657534247,-0.10443587270974
"Chr10","6039371","C","A",40,48,88,160,73,53,126,160,0.420634920634921,0.545454545454545,0.52803738317757,-0.124819624819625
"Chr10","6039377","C","G",46,48,94,160,75,57,132,160,0.431818181818182,0.51063829787234,0.535398230088496,-0.0788201160541586
"Chr10","6039446","A","G",50,53,103,141,87,66,153,141,0.431372549019608,0.514563106796116,0.53515625,-0.0831905577765086
"Chr10","6039474","G","A",49,45,94,160,81,69,150,160,0.46,0.478723404255319,0.532786885245902,-0.0187234042553192
"Chr10","6039671","T","C",38,48,86,160,59,45,104,160,0.432692307692308,0.558139534883721,0.510526315789474,-0.125447227191413
"Chr10","6039751","A","G",38,36,74,160,43,47,90,160,0.522222222222222,0.486486486486487,0.49390243902439,0.0357357357357357
"Chr10","6039765","G","C",36,36,72,141,44,48,92,141,0.521739130434783,0.5,0.48780487804878,0.0217391304347826
"Chr10","6039940","G","A",28,31,59,141,35,35,70,141,0.5,0.525423728813559,0.488372093023256,-0.0254237288135594
"Chr10","6040067","A","G",31,43,74,142,42,44,86,142,0.511627906976744,0.581081081081081,0.45625,-0.0694531741043368
"Chr10","6040098","G","A",34,35,69,141,38,46,84,141,0.547619047619048,0.507246376811594,0.470588235294118,0.0403726708074534
"Chr10","6040272","C","T",33,30,63,160,27,28,55,160,0.509090909090909,0.476190476190476,0.508474576271186,0.0329004329004329
"Chr10","6040366","T","C",43,37,80,160,38,31,69,160,0.449275362318841,0.4625,0.543624161073825,-0.0132246376811594
"Chr10","6041553","A","G",45,54,99,139,67,79,146,139,0.541095890410959,0.545454545454545,0.457142857142857,-0.00435865504358646
"Chr10","6042568","C","T",68,65,133,140,52,67,119,140,0.563025210084034,0.488721804511278,0.476190476190476,0.0743034055727554
"Chr10","6044105","G","A",13,4,17,49,13,14,27,145,0.518518518518518,0.235294117647059,0.590909090909091,0.28322440087146
"Chr10","6044175","A","G",5,5,10,78,7,17,24,138,0.708333333333333,0.5,0.352941176470588,0.208333333333333
"Chr10","6044473","G","A",5,8,13,129,11,3,14,51,0.214285714285714,0.615384615384615,0.592592592592593,-0.401098901098901
"Chr10","6044673","T","C",14,9,23,147,6,7,13,139,0.538461538461538,0.391304347826087,0.555555555555556,0.147157190635451
"Chr10","6045709","A","G",16,16,32,151,17,14,31,151,0.451612903225806,0.5,0.523809523809524,-0.0483870967741936
"Chr10","6045726","A","G",21,19,40,160,24,20,44,160,0.454545454545455,0.475,0.535714285714286,-0.0204545454545454
"Chr10","6045765","C","G",24,22,46,160,35,26,61,160,0.426229508196721,0.478260869565217,0.551401869158878,-0.0520313613684961
"Chr10","6046266","G","T",54,56,110,160,78,65,143,160,0.454545454545455,0.509090909090909,0.521739130434783,-0.0545454545454545
"Chr10","6046630","G","A",54,61,115,160,87,66,153,160,0.431372549019608,0.530434782608696,0.526119402985075,-0.0990622335890878
"Chr10","6046795","T","C",77,47,124,160,82,49,131,160,0.374045801526718,0.379032258064516,0.623529411764706,-0.00498645653779856
"Chr10","6046963","A","G",55,49,104,144,66,74,140,144,0.528571428571429,0.471153846153846,0.495901639344262,0.0574175824175824
"Chr10","6047042","A","G",57,50,107,160,68,94,162,160,0.580246913580247,0.467289719626168,0.464684014869888,0.112957193954079
"Chr10","6047193","G","A",59,66,125,144,64,84,148,144,0.567567567567568,0.528,0.450549450549451,0.0395675675675675
"Chr10","6047239","A","G",57,66,123,160,54,75,129,160,0.581395348837209,0.536585365853659,0.44047619047619,0.0448099829835508
"Chr10","6047303","C","T",57,60,117,147,69,80,149,147,0.536912751677852,0.512820512820513,0.473684210526316,0.0240922388573396
"Chr10","6047356","A","G",64,57,121,142,58,73,131,142,0.557251908396947,0.471074380165289,0.484126984126984,0.0861775282316574
"Chr10","6047365","G","A",66,54,120,160,57,75,132,160,0.568181818181818,0.45,0.488095238095238,0.118181818181818
"Chr10","6047425","T","G",67,63,130,160,56,90,146,160,0.616438356164384,0.484615384615385,0.445652173913043,0.131822971548999
"Chr10","6047480","C","G",48,47,95,160,58,76,134,160,0.567164179104478,0.494736842105263,0.462882096069869,0.0724273369992144
"Chr10","6048006","A","T",50,51,101,146,72,51,123,146,0.414634146341463,0.504950495049505,0.544642857142857,-0.0903163487080416
"Chr10","6048094","A","G",42,38,80,139,47,67,114,139,0.587719298245614,0.475,0.458762886597938,0.112719298245614
"Chr10","6048122","A","T",49,44,93,144,51,70,121,144,0.578512396694215,0.473118279569892,0.467289719626168,0.105394117124322
"Chr10","6048129","G","A",57,49,106,144,57,82,139,144,0.589928057553957,0.462264150943396,0.46530612244898,0.127663906610561
"Chr10","6048153","T","C",66,49,115,146,64,86,150,146,0.573333333333333,0.426086956521739,0.490566037735849,0.147246376811594
"Chr10","6048601","C","G",34,49,83,145,55,55,110,145,0.5,0.590361445783133,0.461139896373057,-0.0903614457831325
"Chr10","6048627","G","A",34,52,86,151,52,55,107,151,0.514018691588785,0.604651162790698,0.44559585492228,-0.0906324712019126
"Chr10","6048955","A","C",68,89,157,136,89,90,179,136,0.502793296089385,0.56687898089172,0.467261904761905,-0.0640856848023342
"Chr10","6048967","A","T",68,85,153,139,88,81,169,139,0.479289940828402,0.555555555555556,0.484472049689441,-0.0762656147271532
"Chr10","6049002","A","G",61,87,148,142,76,89,165,142,0.539393939393939,0.587837837837838,0.437699680511182,-0.0484438984438984
"Chr10","6049048","C","G",73,92,165,160,88,93,181,160,0.513812154696133,0.557575757575758,0.465317919075145,-0.043763602879625
"Chr10","6049198","G","A",67,77,144,160,90,90,180,160,0.5,0.534722222222222,0.484567901234568,-0.0347222222222222
"Chr10","6049257","A","G",67,72,139,140,86,85,171,140,0.497076023391813,0.517985611510791,0.493548387096774,-0.0209095881189785
"Chr10","6049677","A","G",74,94,168,160,92,103,195,160,0.528205128205128,0.55952380952381,0.457300275482094,-0.0313186813186813
"Chr10","6049956","G","A",71,83,154,160,94,85,179,160,0.474860335195531,0.538961038961039,0.495495495495495,-0.0641007037655082
"Chr10","6050356","G","A",93,83,176,136,80,96,176,136,0.545454545454545,0.471590909090909,0.491477272727273,0.0738636363636363
"Chr10","6050544","A","G",72,93,165,138,91,104,195,138,0.533333333333333,0.563636363636364,0.452777777777778,-0.0303030303030303
"Chr10","6050821","T","C",82,91,173,140,86,116,202,140,0.574257425742574,0.526011560693642,0.448,0.0482458650489326
"Chr10","6051037","A","C",95,79,174,141,74,105,179,141,0.58659217877095,0.454022988505747,0.478753541076487,0.132569190265203
"Chr10","6051213","C","T",83,90,173,136,96,96,192,136,0.5,0.520231213872832,0.49041095890411,-0.0202312138728323
"Chr10","6051366","A","G",73,101,174,141,94,115,209,141,0.550239234449761,0.580459770114943,0.436031331592689,-0.0302205356651818
"Chr10","6051545","C","G",82,68,150,136,89,113,202,136,0.559405940594059,0.453333333333333,0.485795454545455,0.106072607260726
"Chr10","6051968","T","C",84,78,162,151,68,85,153,151,0.555555555555556,0.481481481481481,0.482539682539683,0.0740740740740741
"Chr10","6052405","A","G",35,36,71,160,44,52,96,160,0.541666666666667,0.507042253521127,0.473053892215569,0.0346244131455399
"Chr10","6052423","A","G",37,40,77,142,42,54,96,142,0.5625,0.519480519480519,0.456647398843931,0.0430194805194806
"Chr10","6052438","T","C",30,38,68,160,36,49,85,160,0.576470588235294,0.558823529411765,0.431372549019608,0.0176470588235293
"Chr10","6052459","G","A",30,40,70,150,32,45,77,150,0.584415584415584,0.571428571428571,0.421768707482993,0.012987012987013
"Chr10","6052465","A","G",29,38,67,146,32,43,75,146,0.573333333333333,0.567164179104478,0.429577464788732,0.00616915422885578
"Chr10","6052501","C","T",41,45,86,144,36,45,81,144,0.555555555555556,0.523255813953488,0.461077844311377,0.0322997416020672
"Chr10","6052624","G","A",18,32,50,142,11,21,32,142,0.65625,0.64,0.353658536585366,0.01625
"Chr10","6052636","A","G",17,32,49,160,12,22,34,160,0.647058823529412,0.653061224489796,0.349397590361446,-0.00600240096038407
"Chr10","6053173","A","G",5,4,9,101,5,6,11,109,0.545454545454545,0.444444444444444,0.5,0.101010101010101
"Chr10","6053460","G","C",33,14,47,143,25,20,45,143,0.444444444444444,0.297872340425532,0.630434782608696,0.146572104018913
"Chr10","6053470","A","G",33,15,48,144,25,18,43,144,0.418604651162791,0.3125,0.637362637362637,0.106104651162791
"Chr10","6053495","G","A",29,19,48,160,25,29,54,160,0.537037037037037,0.395833333333333,0.529411764705882,0.141203703703704
"Chr10","6053519","A","G",34,18,52,141,31,29,60,141,0.483333333333333,0.346153846153846,0.580357142857143,0.137179487179487
"Chr10","6053547","T","A",34,18,52,160,31,28,59,160,0.474576271186441,0.346153846153846,0.585585585585586,0.128422425032595
"Chr10","6053553","G","T",34,22,56,160,31,32,63,160,0.507936507936508,0.392857142857143,0.546218487394958,0.115079365079365
"Chr10","6053575","G","A",35,23,58,139,34,31,65,139,0.476923076923077,0.396551724137931,0.560975609756098,0.0803713527851459
"Chr10","6053787","C","T",41,27,68,160,37,32,69,160,0.463768115942029,0.397058823529412,0.569343065693431,0.0667092924126172
"Chr10","6053911","T","C",35,35,70,155,52,35,87,155,0.402298850574713,0.5,0.554140127388535,-0.0977011494252873
"Chr10","6053924","A","G",33,33,66,160,47,33,80,160,0.4125,0.5,0.547945205479452,-0.0875
"Chr10","6053963","A","G",28,34,62,151,52,33,85,151,0.388235294117647,0.548387096774194,0.54421768707483,-0.160151802656546
"Chr10","6053970","C","T",27,34,61,140,53,35,88,140,0.397727272727273,0.557377049180328,0.536912751677852,-0.159649776453055
"Chr10","6053996","G","A",29,35,64,160,44,36,80,160,0.45,0.546875,0.506944444444444,-0.096875
"Chr10","6054009","T","C",27,29,56,160,42,33,75,160,0.44,0.517857142857143,0.526717557251908,-0.0778571428571429
"Chr10","6054014","T","C",26,29,55,160,41,31,72,160,0.430555555555556,0.527272727272727,0.52755905511811,-0.0967171717171716
"Chr10","6054353","T","C",37,37,74,160,72,68,140,160,0.485714285714286,0.5,0.509345794392523,-0.0142857142857143
"Chr10","6054600","T","G",62,12,74,95,46,34,80,160,0.425,0.162162162162162,0.701298701298701,0.262837837837838
"Chr10","6054631","G","A",73,41,114,136,71,92,163,136,0.56441717791411,0.359649122807018,0.51985559566787,0.204768055107093
"Chr10","6054738","T","C",55,35,90,141,84,75,159,141,0.471698113207547,0.388888888888889,0.558232931726908,0.0828092243186583
"Chr10","6054818","C","T",67,56,123,160,95,77,172,160,0.447674418604651,0.455284552845528,0.549152542372881,-0.00761013424087725
"Chr10","6054881","C","G",74,74,148,136,102,81,183,136,0.442622950819672,0.5,0.531722054380665,-0.0573770491803279
"Chr10","6054906","G","A",66,80,146,141,81,84,165,141,0.509090909090909,0.547945205479452,0.472668810289389,-0.038854296388543
"Chr10","6054930","C","G",55,47,102,139,70,50,120,139,0.416666666666667,0.46078431372549,0.563063063063063,-0.0441176470588235
"Chr10","6054943","T","C",68,54,122,140,73,51,124,140,0.411290322580645,0.442622950819672,0.573170731707317,-0.0313326282390269
"Chr10","6054978","C","T",87,55,142,160,66,55,121,160,0.454545454545455,0.387323943661972,0.581749049429658,0.0672215108834827
"Chr10","6055018","C","T",108,88,196,136,84,89,173,136,0.514450867052023,0.448979591836735,0.520325203252033,0.0654712752152884
"Chr10","6055063","G","T",104,88,192,142,104,89,193,142,0.461139896373057,0.458333333333333,0.54025974025974,0.00280656303972365
"Chr10","6055220","G","A",58,117,175,139,71,118,189,139,0.624338624338624,0.668571428571429,0.354395604395604,-0.0442328042328043
"Chr10","6056138","G","A",56,92,148,136,64,135,199,136,0.678391959798995,0.621621621621622,0.345821325648415,0.0567703381773734
"Chr10","6056188","A","G",61,77,138,160,62,123,185,160,0.664864864864865,0.557971014492754,0.380804953560372,0.106893850372111
"Chr10","6056221","T","C",55,73,128,136,62,105,167,136,0.62874251497006,0.5703125,0.396610169491525,0.0584300149700598
"Chr10","6056228","T","C",61,56,117,160,59,64,123,160,0.520325203252033,0.478632478632479,0.5,0.0416927246195539
"Chr10","6056312","T","C",76,110,186,160,75,127,202,160,0.628712871287129,0.591397849462366,0.389175257731959,0.0373150218247631
"Chr10","6056417","A","G",86,72,158,160,94,129,223,160,0.57847533632287,0.455696202531646,0.47244094488189,0.122779133791224
"Chr10","6056432","C","T",72,59,131,143,84,108,192,143,0.5625,0.450381679389313,0.48297213622291,0.112118320610687
"Chr10","6056503","C","A",64,66,130,136,98,96,194,136,0.494845360824742,0.507692307692308,0.5,-0.0128469468675654
"Chr10","6056513","C","T",64,63,127,160,97,89,186,160,0.478494623655914,0.496062992125984,0.514376996805112,-0.0175683684700703
"Chr10","6056534","A","G",66,61,127,160,95,82,177,160,0.463276836158192,0.480314960629921,0.529605263157895,-0.0170381244717291
"Chr10","6056684","G","A",71,94,165,160,97,104,201,160,0.517412935323383,0.56969696969697,0.459016393442623,-0.0522840343735866
"Chr10","6056690","T","A",61,84,145,136,88,92,180,136,0.511111111111111,0.579310344827586,0.458461538461538,-0.0681992337164752
"Chr10","6056700","G","A",64,85,149,160,88,95,183,160,0.519125683060109,0.570469798657718,0.457831325301205,-0.0513441155976088
"Chr10","6056876","C","A",61,42,103,160,71,33,104,160,0.317307692307692,0.407766990291262,0.63768115942029,-0.0904592979835698
"Chr10","6056936","T","C",69,46,115,160,65,50,115,160,0.434782608695652,0.4,0.582608695652174,0.0347826086956521
"Chr10","6056959","G","T",73,56,129,141,74,71,145,141,0.489655172413793,0.434108527131783,0.536496350364963,0.0555466452820101
"Chr10","6056986","C","G",82,60,142,160,82,88,170,160,0.517647058823529,0.422535211267606,0.525641025641026,0.0951118475559238
"Chr10","6057015","G","A",77,72,149,153,91,112,203,153,0.551724137931034,0.483221476510067,0.477272727272727,0.0685026614209673
"Chr10","6057057","C","T",83,75,158,160,78,104,182,160,0.571428571428571,0.474683544303797,0.473529411764706,0.096745027124774
"Chr10","6057071","G","A",81,77,158,136,79,109,188,136,0.579787234042553,0.487341772151899,0.46242774566474,0.0924454618906544
"Chr10","6057266","A","G",45,54,99,160,52,96,148,160,0.648648648648649,0.545454545454545,0.392712550607287,0.103194103194103
"Chr10","6057346","A","T",53,48,101,160,43,70,113,160,0.619469026548673,0.475247524752475,0.448598130841121,0.144221501796197
"Chr10","6057353","A","C",58,51,109,160,45,68,113,160,0.601769911504425,0.467889908256881,0.463963963963964,0.133880003247544
"Chr10","6057364","G","A",54,49,103,148,46,70,116,148,0.603448275862069,0.475728155339806,0.45662100456621,0.127720120522263
"Chr10","6057434","A","T",57,63,120,149,49,70,119,149,0.588235294117647,0.525,0.443514644351464,0.0632352941176471
"Chr10","6057510","C","G",56,74,130,139,55,72,127,139,0.566929133858268,0.569230769230769,0.431906614785992,-0.0023016353725015
"Chr10","6057771","T","G",53,58,111,143,65,84,149,143,0.563758389261745,0.522522522522523,0.453846153846154,0.0412358667392224
"Chr10","6057990","A","G",77,65,142,140,64,88,152,140,0.578947368421053,0.457746478873239,0.479591836734694,0.121200889547813
"Chr10","6058081","C","T",63,73,136,154,65,104,169,154,0.615384615384615,0.536764705882353,0.419672131147541,0.0786199095022625
"Chr10","6058126","A","C",71,76,147,136,89,86,175,136,0.491428571428571,0.517006802721088,0.496894409937888,-0.025578231292517
"Chr10","6058217","A","G",92,95,187,140,110,105,215,140,0.488372093023256,0.508021390374332,0.502487562189055,-0.0196492973510758
"Chr10","6058322","G","A",85,86,171,136,73,100,173,136,0.578034682080925,0.502923976608187,0.459302325581395,0.0751107054727378
"Chr10","6058347","T","C",89,85,174,160,68,115,183,160,0.628415300546448,0.488505747126437,0.439775910364146,0.139909553420011
"Chr10","6058474","C","T",64,69,133,145,70,93,163,145,0.570552147239264,0.518796992481203,0.452702702702703,0.0517551547580608
"Chr10","6058750","C","T",89,87,176,140,103,121,224,140,0.540178571428571,0.494318181818182,0.48,0.0458603896103896
"Chr10","6058849","C","A",67,89,156,143,82,75,157,143,0.477707006369427,0.57051282051282,0.476038338658147,-0.0928058141433937
"Chr10","6058965","T","C",82,86,168,139,101,111,212,139,0.523584905660377,0.511904761904762,0.481578947368421,0.0116801437556155
"Chr10","6058972","A","T",83,83,166,160,110,112,222,160,0.504504504504504,0.5,0.497422680412371,0.00450450450450446
"Chr10","6059188","A","C",74,67,141,160,108,110,218,160,0.504587155963303,0.475177304964539,0.506963788300836,0.0294098509987637
"Chr10","6059225","T","C",75,85,160,160,105,129,234,160,0.551282051282051,0.53125,0.456852791878173,0.0200320512820513
"Chr10","6059259","A","T",83,87,170,138,95,107,202,138,0.52970297029703,0.511764705882353,0.478494623655914,0.0179382644146768
"Chr10","6059338","T","A",84,101,185,160,122,140,262,160,0.534351145038168,0.545945945945946,0.460850111856823,-0.011594800907778
"Chr10","6059384","A","G",83,87,170,160,106,113,219,160,0.515981735159817,0.511764705882353,0.48586118251928,0.00421702927746448
"Chr10","6059389","T","C",76,86,162,160,106,112,218,160,0.513761467889908,0.530864197530864,0.478947368421053,-0.0171027296409559
"Chr10","6059588","T","C",69,68,137,142,72,74,146,142,0.506849315068493,0.496350364963504,0.498233215547703,0.0104989501049895
"Chr10","6059670","G","A",65,81,146,147,65,89,154,147,0.577922077922078,0.554794520547945,0.433333333333333,0.0231275573741327
"Chr10","6059697","G","A",66,77,143,141,67,87,154,141,0.564935064935065,0.538461538461538,0.447811447811448,0.0264735264735265
"Chr10","6059937","C","A",78,90,168,140,89,75,164,140,0.457317073170732,0.535714285714286,0.503012048192771,-0.078397212543554
"Chr10","6060003","A","G",73,73,146,160,99,67,166,160,0.403614457831325,0.5,0.551282051282051,-0.0963855421686747
"Chr10","6060049","A","G",71,74,145,139,99,85,184,139,0.46195652173913,0.510344827586207,0.516717325227964,-0.0483883058470765
"Chr10","6060108","A","G",69,72,141,160,88,84,172,160,0.488372093023256,0.51063829787234,0.501597444089457,-0.0222662048490846
"Chr10","6060153","A","G",78,70,148,141,74,85,159,141,0.534591194968553,0.472972972972973,0.495114006514658,0.0616182219955805
"Chr10","6060336","C","T",71,68,139,160,86,84,170,160,0.494117647058824,0.489208633093525,0.508090614886731,0.00490901396529836
"Chr10","6060492","C","T",68,73,141,139,104,96,200,139,0.48,0.517730496453901,0.504398826979472,-0.0377304964539007
"Chr10","6060520","T","G",63,70,133,160,93,97,190,160,0.510526315789474,0.526315789473684,0.48297213622291,-0.0157894736842105
"Chr10","6060662","T","A",81,72,153,135,113,112,225,135,0.497777777777778,0.470588235294118,0.513227513227513,0.0271895424836601
"Chr10","6060667","C","A",83,73,156,160,118,112,230,160,0.48695652173913,0.467948717948718,0.520725388601036,0.0190078037904125
"Chr10","6060704","A","T",73,72,145,136,100,106,206,136,0.514563106796116,0.496551724137931,0.492877492877493,0.0180113826581855
"Chr10","6060741","A","G",70,68,138,160,90,97,187,160,0.518716577540107,0.492753623188406,0.492307692307692,0.0259629543517011
"Chr10","6060768","T","C",61,59,120,136,105,103,208,136,0.495192307692308,0.491666666666667,0.50609756097561,0.00352564102564107
"Chr10","6060850","T","C",74,70,144,160,91,104,195,160,0.533333333333333,0.486111111111111,0.486725663716814,0.0472222222222222
"Chr10","6061037","G","A",59,63,122,143,89,81,170,143,0.476470588235294,0.516393442622951,0.506849315068493,-0.0399228543876567
"Chr10","6061105","A","T",55,57,112,160,68,82,150,160,0.546666666666667,0.508928571428571,0.469465648854962,0.0377380952380952
"Chr10","6061128","G","A",60,53,113,160,73,83,156,160,0.532051282051282,0.469026548672566,0.494423791821561,0.0630247333787157
"Chr10","6061141","C","T",59,52,111,160,76,80,156,160,0.512820512820513,0.468468468468468,0.50561797752809,0.0443520443520443
"Chr10","6061210","T","C",60,61,121,160,85,70,155,160,0.451612903225806,0.504132231404959,0.52536231884058,-0.0525193281791522
"Chr10","6061217","C","T",62,59,121,142,89,71,160,142,0.44375,0.487603305785124,0.537366548042705,-0.043853305785124
"Chr10","6061308","T","C",47,57,104,141,68,45,113,141,0.398230088495575,0.548076923076923,0.529953917050691,-0.149846834581348
"Chr10","6061390","G","A",67,63,130,160,85,48,133,160,0.360902255639098,0.484615384615385,0.577946768060836,-0.123713128976287
"Chr10","6061696","G","A",52,26,78,139,40,27,67,139,0.402985074626866,0.333333333333333,0.63448275862069,0.0696517412935324
"Chr10","6061741","T","C",45,30,75,160,40,20,60,160,0.333333333333333,0.4,0.62962962962963,-0.0666666666666667
"Chr10","6062568","C","A",18,22,40,139,22,24,46,139,0.521739130434783,0.55,0.465116279069767,-0.0282608695652175
"Chr10","6062705","T","C",23,35,58,160,30,32,62,160,0.516129032258065,0.603448275862069,0.441666666666667,-0.0873192436040044
"Chr10","6064286","A","T",47,46,93,160,65,58,123,160,0.471544715447154,0.494623655913978,0.518518518518518,-0.023078940466824
"Chr10","6064339","C","T",52,55,107,146,49,53,102,146,0.519607843137255,0.514018691588785,0.483253588516746,0.00558915154846995
"Chr10","6064848","A","G",52,74,126,160,49,70,119,160,0.588235294117647,0.587301587301587,0.412244897959184,0.000933706816059754
"Chr10","6065591","T","C",61,53,114,160,78,76,154,160,0.493506493506494,0.464912280701754,0.51865671641791,0.0285942128047391
"Chr10","6073177","A","G",34,33,67,142,47,29,76,142,0.381578947368421,0.492537313432836,0.566433566433566,-0.110958366064415
"Chr10","6073754","A","G",5,14,19,76,9,15,24,143,0.625,0.736842105263158,0.325581395348837,-0.111842105263158
"Chr10","6075986","A","G",22,21,43,160,39,33,72,160,0.458333333333333,0.488372093023256,0.530434782608696,-0.0300387596899225
"Chr10","6078678","A","G",12,7,19,160,21,29,50,160,0.58,0.368421052631579,0.478260869565217,0.211578947368421
"Chr10","6079436","A","G",27,33,60,142,37,63,100,142,0.63,0.55,0.4,0.08
"Chr10","6080883","G","A",27,35,62,151,29,31,60,151,0.516666666666667,0.564516129032258,0.459016393442623,-0.0478494623655914
"Chr10","6080938","A","T",36,35,71,139,35,33,68,139,0.485294117647059,0.492957746478873,0.510791366906475,-0.00766362883181443
"Chr10","6081146","G","C",28,21,49,144,34,26,60,144,0.433333333333333,0.428571428571429,0.568807339449541,0.0047619047619048
"Chr10","6081203","G","A",19,16,35,143,27,32,59,143,0.542372881355932,0.457142857142857,0.48936170212766,0.0852300242130751
"Chr10","6101459","T","A",17,10,27,145,19,20,39,145,0.512820512820513,0.37037037037037,0.545454545454545,0.142450142450142
"Chr10","6146618","T","A",48,47,95,141,57,54,111,141,0.486486486486487,0.494736842105263,0.509708737864078,-0.00825035561877663
"Chr10","6220616","T","A",41,30,71,143,46,52,98,143,0.530612244897959,0.422535211267606,0.514792899408284,0.108077033630354
"Chr10","6237259","G","A",21,25,46,142,20,21,41,142,0.51219512195122,0.543478260869565,0.471264367816092,-0.0312831389183457
"Chr10","6237475","T","A",31,41,72,160,32,49,81,160,0.604938271604938,0.569444444444444,0.411764705882353,0.0354938271604939
"Chr10","6237723","C","T",35,31,66,140,51,41,92,140,0.445652173913043,0.46969696969697,0.544303797468354,-0.0240447957839263
"Chr10","6238634","G","A",86,63,149,143,93,65,158,143,0.411392405063291,0.422818791946309,0.583061889250814,-0.0114263868830176
"Chr10","6238845","T","A",67,65,132,142,68,60,128,142,0.46875,0.492424242424242,0.519230769230769,-0.0236742424242424
"Chr10","6240001","A","G",45,29,74,143,70,58,128,143,0.453125,0.391891891891892,0.569306930693069,0.0612331081081081
"Chr10","6240068","G","A",37,23,60,140,49,52,101,140,0.514851485148515,0.383333333333333,0.53416149068323,0.131518151815182
"Chr10","6240327","C","T",43,59,102,136,80,82,162,136,0.506172839506173,0.57843137254902,0.465909090909091,-0.0722585330428468
"Chr10","6241048","T","A",60,49,109,160,61,57,118,160,0.483050847457627,0.44954128440367,0.533039647577093,0.0335095630539574
"Chr10","6241117","G","A",56,36,92,140,43,50,93,140,0.537634408602151,0.391304347826087,0.535135135135135,0.146330060776064
"Chr10","6241122","T","A",38,54,92,139,50,43,93,139,0.462365591397849,0.58695652173913,0.475675675675676,-0.124590930341281
"Chr10","6241128","T","C",38,55,93,141,54,44,98,141,0.448979591836735,0.591397849462366,0.481675392670157,-0.142418257625631
"Chr10","6241162","G","C",41,58,99,140,64,45,109,140,0.412844036697248,0.585858585858586,0.504807692307692,-0.173014549161338
"Chr10","6241992","G","C",18,23,41,145,22,24,46,145,0.521739130434783,0.560975609756098,0.459770114942529,-0.039236479321315
"Chr10","6242509","G","A",14,16,30,160,12,16,28,160,0.571428571428571,0.533333333333333,0.448275862068966,0.0380952380952381
"Chr10","6243422","G","A",18,17,35,142,16,14,30,142,0.466666666666667,0.485714285714286,0.523076923076923,-0.019047619047619
"Chr10","6243754","T","C",29,36,65,141,31,52,83,141,0.626506024096386,0.553846153846154,0.405405405405405,0.0726598702502317
"Chr10","6243759","G","C",34,30,64,160,56,34,90,160,0.377777777777778,0.46875,0.584415584415584,-0.0909722222222222
"Chr10","6243866","G","A",32,28,60,142,41,47,88,142,0.534090909090909,0.466666666666667,0.493243243243243,0.0674242424242424
"Chr10","6244089","G","A",37,29,66,149,31,33,64,149,0.515625,0.439393939393939,0.523076923076923,0.0762310606060606
"Chr10","6244288","G","A",27,36,63,144,46,44,90,144,0.488888888888889,0.571428571428571,0.477124183006536,-0.0825396825396825
"Chr10","6244693","A","C",32,26,58,160,30,32,62,160,0.516129032258065,0.448275862068966,0.516666666666667,0.067853170189099
"Chr10","6244766","A","T",26,24,50,143,27,30,57,143,0.526315789473684,0.48,0.495327102803738,0.0463157894736842
"Chr10","6244778","C","T",22,23,45,154,20,20,40,154,0.5,0.511111111111111,0.494117647058824,-0.0111111111111111
"Chr10","6261135","G","A",21,20,41,143,21,28,49,143,0.571428571428571,0.48780487804878,0.466666666666667,0.0836236933797909
"Chr10","6261604","G","A",26,43,69,160,55,46,101,160,0.455445544554455,0.623188405797101,0.476470588235294,-0.167742861242646
"Chr10","6261660","T","A",57,28,85,160,58,59,117,160,0.504273504273504,0.329411764705882,0.569306930693069,0.174861739567622
"Chr10","6261669","G","A",33,47,80,160,74,46,120,160,0.383333333333333,0.5875,0.535,-0.204166666666667
"Chr10","6262002","T","A",35,42,77,140,29,50,79,140,0.632911392405063,0.545454545454545,0.41025641025641,0.0874568469505179
"Chr10","6262043","C","T",33,44,77,160,38,53,91,160,0.582417582417582,0.571428571428571,0.422619047619048,0.0109890109890111
"Chr10","6262104","T","C",37,47,84,142,31,51,82,142,0.621951219512195,0.55952380952381,0.409638554216867,0.0624274099883856
"Chr10","6262236","C","A",48,49,97,160,47,36,83,160,0.433734939759036,0.505154639175258,0.527777777777778,-0.0714196994162216
"Chr10","6262317","C","A",37,32,69,160,60,47,107,160,0.439252336448598,0.463768115942029,0.551136363636364,-0.0245157794934309
"Chr10","6262561","G","A",23,38,61,160,30,35,65,160,0.538461538461538,0.622950819672131,0.420634920634921,-0.0844892812105927
"Chr10","6262795","C","T",35,41,76,147,33,42,75,147,0.56,0.539473684210526,0.450331125827815,0.0205263157894737
"Chr10","6264352","A","T",8,8,16,160,14,17,31,160,0.548387096774194,0.5,0.468085106382979,0.0483870967741935
"Chr10","6264497","T","C",5,9,14,111,11,9,20,145,0.45,0.642857142857143,0.470588235294118,-0.192857142857143
"Chr10","6264646","T","A",16,5,21,66,6,11,17,137,0.647058823529412,0.238095238095238,0.578947368421053,0.408963585434174
"Chr10","6264653","G","A",14,7,21,144,7,10,17,160,0.588235294117647,0.333333333333333,0.552631578947368,0.254901960784314
"Chr10","6264701","A","G",10,8,18,151,8,7,15,130,0.466666666666667,0.444444444444444,0.545454545454545,0.0222222222222223
"Chr10","6264867","G","A",3,9,12,65,9,11,20,160,0.55,0.75,0.375,-0.2
"Chr10","6265023","G","C",8,9,17,146,16,14,30,146,0.466666666666667,0.529411764705882,0.51063829787234,-0.0627450980392157
"Chr10","6265050","C","T",10,9,19,160,14,18,32,160,0.5625,0.473684210526316,0.470588235294118,0.0888157894736842
"Chr10","6265157","T","C",10,8,18,145,17,6,23,122,0.260869565217391,0.444444444444444,0.658536585365854,-0.183574879227053
"Chr10","6265245","C","T",9,18,27,160,12,17,29,160,0.586206896551724,0.666666666666667,0.375,-0.0804597701149425
"Chr10","6265416","C","T",14,20,34,151,11,14,25,151,0.56,0.588235294117647,0.423728813559322,-0.028235294117647
"Chr10","6265417","G","A",22,14,36,160,15,11,26,160,0.423076923076923,0.388888888888889,0.596774193548387,0.0341880341880342
"Chr10","6265571","A","G",21,19,40,145,19,27,46,145,0.58695652173913,0.475,0.465116279069767,0.111956521739131
"Chr10","6265633","G","C",21,21,42,143,28,28,56,143,0.5,0.5,0.5,0
"Chr10","6265917","T","C",33,30,63,160,47,29,76,160,0.381578947368421,0.476190476190476,0.575539568345324,-0.0946115288220551
"Chr10","6266051","T","C",23,22,45,144,43,30,73,144,0.410958904109589,0.488888888888889,0.559322033898305,-0.0779299847792999
"Chr10","6266569","G","A",27,26,53,160,31,22,53,160,0.415094339622642,0.490566037735849,0.547169811320755,-0.0754716981132075
"Chr10","6266706","A","G",29,30,59,160,15,30,45,160,0.666666666666667,0.508474576271186,0.423076923076923,0.15819209039548
"Chr10","6267153","G","A",42,46,88,146,57,28,85,146,0.329411764705882,0.522727272727273,0.572254335260116,-0.19331550802139
"Chr10","6267385","G","C",45,50,95,160,55,75,130,160,0.576923076923077,0.526315789473684,0.444444444444444,0.0506072874493927
"Chr10","6267405","G","A",51,45,96,140,68,55,123,140,0.447154471544715,0.46875,0.54337899543379,-0.0215955284552846
"Chr10","6267456","G","A",42,50,92,160,52,78,130,160,0.6,0.543478260869565,0.423423423423423,0.0565217391304348
"Chr10","6267476","G","A",44,47,91,140,48,77,125,140,0.616,0.516483516483517,0.425925925925926,0.0995164835164835
"Chr10","6267960","C","G",35,28,63,142,43,41,84,142,0.488095238095238,0.444444444444444,0.530612244897959,0.0436507936507937
"Chr10","6268072","C","T",52,32,84,160,48,29,77,160,0.376623376623377,0.380952380952381,0.62111801242236,-0.00432900432900429
"Chr10","6271879","G","T",86,75,161,160,98,93,191,160,0.486910994764398,0.46583850931677,0.522727272727273,0.0210724854476277
"Chr10","6271925","G","A",70,75,145,153,113,108,221,153,0.48868778280543,0.517241379310345,0.5,-0.028553596504915
"Chr10","6272353","G","A",61,64,125,141,82,59,141,141,0.418439716312057,0.512,0.537593984962406,-0.0935602836879433
"Chr10","6272370","G","A",62,57,119,143,59,88,147,143,0.598639455782313,0.478991596638655,0.454887218045113,0.119647859143657
"Chr10","6272397","C","T",55,49,104,142,47,76,123,142,0.617886178861789,0.471153846153846,0.449339207048458,0.146732332707943
"Chr10","6272413","G","A",56,48,104,160,46,68,114,160,0.596491228070175,0.461538461538462,0.467889908256881,0.134952766531714
"Chr10","6272876","T","C",47,40,87,143,40,46,86,143,0.534883720930233,0.459770114942529,0.502890173410405,0.0751136059877038
"Chr10","6273714","G","A",28,27,55,160,30,43,73,160,0.589041095890411,0.490909090909091,0.453125,0.0981320049813201
"Chr10","6273727","C","G",22,26,48,160,31,46,77,160,0.597402597402597,0.541666666666667,0.424,0.0557359307359307
"Chr10","6273968","C","T",21,25,46,160,37,30,67,160,0.447761194029851,0.543478260869565,0.513274336283186,-0.0957170668397144
"Chr10","6274493","G","C",52,57,109,143,56,66,122,143,0.540983606557377,0.522935779816514,0.467532467532468,0.0180478267408634
"Chr10","6274532","G","A",44,45,89,156,44,56,100,156,0.56,0.50561797752809,0.465608465608466,0.0543820224719102
"Chr10","6275101","G","A",14,12,26,137,14,19,33,137,0.575757575757576,0.461538461538462,0.474576271186441,0.114219114219114
"Chr10","6275610","G","A",39,24,63,139,50,53,103,139,0.514563106796116,0.380952380952381,0.536144578313253,0.133610725843736
"Chr10","6278891","G","A",24,28,52,147,41,23,64,147,0.359375,0.538461538461538,0.560344827586207,-0.179086538461538
"Chr10","6278904","G","A",31,19,50,142,29,32,61,142,0.524590163934426,0.38,0.540540540540541,0.144590163934426
"Chr10","6280134","T","A",59,55,114,160,72,53,125,160,0.424,0.482456140350877,0.548117154811716,-0.0584561403508772
"Chr10","6281565","T","C",17,23,40,160,26,21,47,160,0.446808510638298,0.575,0.494252873563218,-0.128191489361702
"Chr10","6281596","C","G",18,26,44,147,23,23,46,147,0.5,0.590909090909091,0.455555555555556,-0.0909090909090909
"Chr10","6281647","C","T",17,22,39,147,19,20,39,147,0.512820512820513,0.564102564102564,0.461538461538462,-0.0512820512820513
"Chr10","6281967","C","T",7,17,24,138,17,17,34,147,0.5,0.708333333333333,0.413793103448276,-0.208333333333333
"Chr10","6282253","G","A",18,28,46,146,39,48,87,146,0.551724137931034,0.608695652173913,0.428571428571429,-0.0569715142428786
"Chr10","6282723","G","A",18,18,36,143,30,31,61,143,0.508196721311475,0.5,0.494845360824742,0.00819672131147542
"Chr10","6282741","A","T",25,21,46,160,40,38,78,160,0.487179487179487,0.456521739130435,0.524193548387097,0.0306577480490524
"Chr10","6283060","A","T",19,15,34,160,20,17,37,160,0.459459459459459,0.441176470588235,0.549295774647887,0.0182829888712242
"Chr10","6283796","C","G",21,27,48,160,19,19,38,160,0.5,0.5625,0.465116279069767,-0.0625
"Chr10","6283805","C","T",21,28,49,160,18,22,40,160,0.55,0.571428571428571,0.438202247191011,-0.0214285714285714
"Chr10","6283841","C","G",23,25,48,146,18,22,40,146,0.55,0.520833333333333,0.465909090909091,0.0291666666666667
"Chr10","6284187","G","T",47,40,87,149,48,46,94,149,0.48936170212766,0.459770114942529,0.524861878453039,0.0295915871851308
"Chr10","6284479","G","A",56,49,105,140,58,57,115,140,0.495652173913044,0.466666666666667,0.518181818181818,0.0289855072463768
"Chr10","6284517","C","A",53,51,104,160,59,57,116,160,0.491379310344828,0.490384615384615,0.509090909090909,0.000994694960212206
"Chr10","6284650","T","G",54,46,100,160,63,75,138,160,0.543478260869565,0.46,0.491596638655462,0.0834782608695652
"Chr10","6284700","T","C",51,59,110,144,90,69,159,144,0.433962264150943,0.536363636363636,0.524163568773234,-0.102401372212693
"Chr10","6284939","A","C",66,62,128,139,75,59,134,139,0.440298507462687,0.484375,0.538167938931298,-0.0440764925373134
"Chr10","6285249","T","A",57,60,117,160,75,57,132,160,0.431818181818182,0.512820512820513,0.530120481927711,-0.081002331002331
"Chr10","6285584","C","A",42,50,92,141,39,58,97,141,0.597938144329897,0.543478260869565,0.428571428571429,0.0544598834603317
"Chr10","6285972","C","A",58,62,120,160,77,59,136,160,0.433823529411765,0.516666666666667,0.52734375,-0.082843137254902
"Chr10","6293929","T","C",63,45,108,139,78,72,150,139,0.48,0.416666666666667,0.546511627906977,0.0633333333333333
"Chr10","6297038","G","C",21,29,50,160,25,13,38,160,0.342105263157895,0.58,0.522727272727273,-0.237894736842105
"Chr10","6297207","G","C",15,11,26,154,12,17,29,154,0.586206896551724,0.423076923076923,0.490909090909091,0.163129973474801
"Chr10","6297225","G","C",9,12,21,160,12,10,22,160,0.454545454545455,0.571428571428571,0.488372093023256,-0.116883116883117
"Chr10","6297968","A","G",30,48,78,141,67,61,128,141,0.4765625,0.615384615384615,0.470873786407767,-0.138822115384615
"Chr10","6298269","G","A",59,64,123,141,61,71,132,141,0.537878787878788,0.520325203252033,0.470588235294118,0.0175535846267553
"Chr10","6299820","C","A",32,28,60,160,35,30,65,160,0.461538461538462,0.466666666666667,0.536,-0.00512820512820511
"Chr10","6300047","C","T",47,46,93,151,50,45,95,151,0.473684210526316,0.494623655913978,0.515957446808511,-0.0209394453876627
"Chr10","6300076","A","T",40,42,82,160,46,46,92,160,0.5,0.51219512195122,0.494252873563218,-0.0121951219512195
"Chr10","6300947","C","T",41,34,75,139,70,81,151,139,0.536423841059603,0.453333333333333,0.491150442477876,0.0830905077262693
"Chr10","6300995","C","T",41,36,77,160,82,85,167,160,0.508982035928144,0.467532467532468,0.504098360655738,0.0414495683956762
"Chr10","6302914","T","C",75,65,140,160,79,77,156,160,0.493589743589744,0.464285714285714,0.52027027027027,0.0293040293040293
"Chr10","6302952","C","A",56,38,94,139,62,61,123,139,0.495934959349593,0.404255319148936,0.543778801843318,0.0916796402006573
"Chr10","6302966","G","C",55,36,91,160,62,58,120,160,0.483333333333333,0.395604395604396,0.554502369668246,0.0877289377289378
"Chr10","6302973","A","T",54,39,93,160,61,57,118,160,0.483050847457627,0.419354838709677,0.545023696682464,0.0636960087479497
"Chr10","6302978","A","T",57,37,94,160,63,59,122,160,0.483606557377049,0.393617021276596,0.555555555555556,0.0899895361004534
"Chr10","6302995","T","C",59,39,98,160,65,66,131,160,0.50381679389313,0.397959183673469,0.541484716157205,0.10585761021966
"Chr10","6303010","G","A",59,42,101,140,71,77,148,140,0.52027027027027,0.415841584158416,0.522088353413655,0.104428686111854
"Chr10","6303048","T","C",51,45,96,140,73,76,149,140,0.51006711409396,0.46875,0.506122448979592,0.0413171140939598
"Chr10","6303055","A","G",55,45,100,160,70,74,144,160,0.513888888888889,0.45,0.512295081967213,0.0638888888888888
"Chr10","6303127","G","C",27,58,85,160,43,70,113,160,0.619469026548673,0.682352941176471,0.353535353535354,-0.0628839146277981
"Chr10","6303189","G","A",54,24,78,142,58,40,98,142,0.408163265306122,0.307692307692308,0.636363636363636,0.100470957613815
"Chr10","6303256","T","A",60,28,88,160,72,67,139,160,0.482014388489209,0.318181818181818,0.581497797356828,0.16383257030739
"Chr10","6303310","C","T",58,39,97,160,79,75,154,160,0.487012987012987,0.402061855670103,0.545816733067729,0.0849511313428839
"Chr10","6303590","G","C",28,13,41,160,22,21,43,160,0.488372093023256,0.317073170731707,0.595238095238095,0.171298922291548
"Chr10","6309107","G","A",33,28,61,160,27,38,65,160,0.584615384615385,0.459016393442623,0.476190476190476,0.125598991172762
"Chr10","6309108","A","G",29,33,62,160,39,28,67,160,0.417910447761194,0.532258064516129,0.527131782945736,-0.114347616754935
"Chr10","6319608","C","T",74,63,137,160,74,86,160,160,0.5375,0.45985401459854,0.498316498316498,0.0776459854014598
"Chr10","6334687","G","A",44,53,97,160,68,67,135,160,0.496296296296296,0.54639175257732,0.482758620689655,-0.0500954562810232
"Chr10","6340400","T","C",48,64,112,160,64,79,143,160,0.552447552447552,0.571428571428571,0.43921568627451,-0.018981018981019
"Chr10","6344290","G","A",75,83,158,136,83,80,163,136,0.49079754601227,0.525316455696203,0.492211838006231,-0.0345189096839326
"Chr10","6345986","T","C",47,35,82,160,43,52,95,160,0.547368421052632,0.426829268292683,0.508474576271186,0.120539152759949
"Chr10","6346505","T","G",26,14,40,160,23,41,64,160,0.640625,0.35,0.471153846153846,0.290625
"Chr10","6347018","C","T",23,34,57,160,28,25,53,160,0.471698113207547,0.596491228070175,0.463636363636364,-0.124793114862628
"Chr10","6347263","T","C",32,24,56,140,28,24,52,140,0.461538461538462,0.428571428571429,0.555555555555556,0.032967032967033
"Chr10","6347457","C","T",14,24,38,146,28,16,44,146,0.363636363636364,0.631578947368421,0.51219512195122,-0.267942583732057
"Chr10","6347641","C","G",20,27,47,160,40,36,76,160,0.473684210526316,0.574468085106383,0.48780487804878,-0.100783874580067
"Chr10","6348006","C","T",23,24,47,160,41,44,85,160,0.517647058823529,0.51063829787234,0.484848484848485,0.00700876095118907
"Chr10","6348296","C","A",23,19,42,145,29,23,52,145,0.442307692307692,0.452380952380952,0.553191489361702,-0.0100732600732601
"Chr10","6348507","G","T",13,8,21,147,17,15,32,147,0.46875,0.380952380952381,0.566037735849057,0.0877976190476191
"Chr10","6348534","A","G",13,8,21,142,19,17,36,142,0.472222222222222,0.380952380952381,0.56140350877193,0.0912698412698413
"Chr10","6349270","T","C",66,68,134,139,70,71,141,139,0.50354609929078,0.507462686567164,0.494545454545455,-0.00391658727638411
"Chr10","6349677","T","C",54,37,91,160,57,52,109,160,0.477064220183486,0.406593406593407,0.555,0.0704708135900797
"Chr10","6349810","T","C",45,39,84,139,66,58,124,139,0.467741935483871,0.464285714285714,0.533653846153846,0.00345622119815664
"Chr10","6349825","G","T",51,51,102,141,64,57,121,141,0.471074380165289,0.5,0.515695067264574,-0.0289256198347108
"Chr10","6349833","G","T",52,54,106,160,68,61,129,160,0.472868217054264,0.509433962264151,0.51063829787234,-0.0365657452098874
"Chr10","6349835","G","A",52,53,105,139,63,70,133,139,0.526315789473684,0.504761904761905,0.483193277310924,0.0215538847117794
"Chr10","6349848","A","T",53,54,107,160,68,64,132,160,0.484848484848485,0.504672897196262,0.506276150627615,-0.0198244123477768
"Chr10","6349854","A","C",56,54,110,143,64,67,131,143,0.511450381679389,0.490909090909091,0.49792531120332,0.0205412907702984
"Chr10","6350184","A","T",28,33,61,160,50,41,91,160,0.450549450549451,0.540983606557377,0.513157894736842,-0.0904341560079265
"Chr10","6350409","A","G",35,31,66,160,33,27,60,160,0.45,0.46969696969697,0.53968253968254,-0.0196969696969697
"Chr10","6350964","G","A",54,59,113,154,60,62,122,154,0.508196721311475,0.52212389380531,0.485106382978723,-0.0139271724938343
"Chr10","6351433","C","T",46,31,77,141,51,55,106,141,0.518867924528302,0.402597402597403,0.530054644808743,0.116270521930899
"Chr10","6351580","C","A",47,34,81,160,36,46,82,160,0.560975609756098,0.419753086419753,0.50920245398773,0.141222523336345
"Chr10","6351639","T","C",53,33,86,160,39,54,93,160,0.580645161290323,0.383720930232558,0.513966480446927,0.196924231057764
"Chr10","6351735","G","A",28,43,71,140,51,41,92,140,0.445652173913043,0.605633802816901,0.484662576687117,-0.159981628903858
"Chr10","6352005","T","C",40,27,67,160,47,39,86,160,0.453488372093023,0.402985074626866,0.568627450980392,0.0505032974661576
"Chr10","6352274","A","G",61,68,129,138,64,68,132,138,0.515151515151515,0.527131782945736,0.478927203065134,-0.0119802677942213
"Chr10","6352405","C","T",40,43,83,140,44,48,92,140,0.521739130434783,0.518072289156627,0.48,0.00366684127815609
"Chr10","6352614","T","A",24,33,57,143,25,43,68,143,0.632352941176471,0.578947368421053,0.392,0.0534055727554179
"Chr10","6355212","C","A",15,14,29,149,15,20,35,149,0.571428571428571,0.482758620689655,0.46875,0.0886699507389162
"Chr10","6359945","T","G",10,13,23,144,13,12,25,144,0.48,0.565217391304348,0.479166666666667,-0.0852173913043478
"Chr10","6360162","T","A",29,17,46,144,20,30,50,144,0.6,0.369565217391304,0.510416666666667,0.230434782608696
"Chr10","6360252","G","C",35,12,47,152,28,37,65,152,0.569230769230769,0.25531914893617,0.5625,0.313911620294599
"Chr10","6360265","C","T",34,11,45,160,26,38,64,160,0.59375,0.244444444444444,0.55045871559633,0.349305555555556
"Chr10","6360778","G","A",31,18,49,160,28,22,50,160,0.44,0.36734693877551,0.595959595959596,0.0726530612244898
"Chr10","6360910","C","A",25,18,43,160,21,29,50,160,0.58,0.418604651162791,0.494623655913978,0.161395348837209
"Chr10","6360919","C","A",23,20,43,160,19,29,48,160,0.604166666666667,0.465116279069767,0.461538461538462,0.139050387596899
"Chr10","6371626","T","A",64,74,138,139,89,101,190,139,0.531578947368421,0.536231884057971,0.466463414634146,-0.00465293668955002
"Chr10","6376590","G","A",33,25,58,160,40,31,71,160,0.436619718309859,0.431034482758621,0.565891472868217,0.00558523555123847
"Chr10","6377134","T","G",15,19,34,160,16,18,34,160,0.529411764705882,0.558823529411765,0.455882352941176,-0.0294117647058824
"Chr10","6377291","T","C",12,13,25,147,5,10,15,112,0.666666666666667,0.52,0.425,0.146666666666667
"Chr10","6377413","G","A",18,11,29,142,15,15,30,142,0.5,0.379310344827586,0.559322033898305,0.120689655172414
"Chr10","6377443","C","G",15,11,26,142,19,14,33,142,0.424242424242424,0.423076923076923,0.576271186440678,0.00116550116550118
"Chr10","6377765","T","C",24,31,55,139,45,40,85,139,0.470588235294118,0.563636363636364,0.492857142857143,-0.093048128342246
"Chr10","6377823","G","A",18,25,43,160,37,29,66,160,0.439393939393939,0.581395348837209,0.504587155963303,-0.14200140944327
"Chr10","6377859","A","T",32,22,54,146,41,29,70,146,0.414285714285714,0.407407407407407,0.588709677419355,0.00687830687830693
"Chr10","6378442","C","T",44,53,97,141,48,70,118,141,0.593220338983051,0.54639175257732,0.427906976744186,0.0468285864057313
"Chr10","6378800","A","G",44,62,106,141,43,82,125,141,0.656,0.584905660377358,0.376623376623377,0.0710943396226416
"Chr10","6378879","G","A",63,55,118,138,80,92,172,138,0.534883720930233,0.466101694915254,0.493103448275862,0.0687820260149783
"Chr10","6378962","A","G",65,52,117,160,87,96,183,160,0.524590163934426,0.444444444444444,0.506666666666667,0.0801457194899818
"Chr10","6379200","G","C",55,68,123,141,55,67,122,141,0.549180327868853,0.552845528455285,0.448979591836735,-0.00366520058643205
"Chr10","6379565","G","C",58,46,104,160,44,65,109,160,0.596330275229358,0.442307692307692,0.47887323943662,0.154022582921665
"Chr10","6379741","A","G",44,46,90,160,48,40,88,160,0.454545454545455,0.511111111111111,0.51685393258427,-0.0565656565656565
"Chr10","6380113","T","C",47,41,88,149,43,52,95,149,0.547368421052632,0.465909090909091,0.491803278688525,0.0814593301435407
"Chr10","6380202","G","C",36,37,73,141,29,46,75,141,0.613333333333333,0.506849315068493,0.439189189189189,0.10648401826484
"Chr10","6384147","G","A",55,52,107,160,62,69,131,160,0.526717557251908,0.485981308411215,0.491596638655462,0.0407362488406934
"Chr10","6385787","T","C",50,53,103,160,48,61,109,160,0.559633027522936,0.514563106796116,0.462264150943396,0.0450699207268193
"Chr10","6385833","A","T",38,42,80,160,42,54,96,160,0.5625,0.525,0.454545454545455,0.0375
"Chr10","6389451","C","T",32,28,60,142,48,47,95,142,0.494736842105263,0.466666666666667,0.516129032258065,0.0280701754385965
"Chr10","6389799","A","G",70,69,139,160,86,77,163,160,0.47239263803681,0.496402877697842,0.516556291390728,-0.0240102396610319
"Chr10","6390050","G","T",58,39,97,142,44,50,94,142,0.531914893617021,0.402061855670103,0.534031413612565,0.129853037946918
"Chr10","6391587","A","G",46,34,80,142,64,60,124,142,0.483870967741935,0.425,0.53921568627451,0.0588709677419355
"Chr10","6391808","C","T",71,78,149,141,111,118,229,141,0.51528384279476,0.523489932885906,0.481481481481481,-0.00820609009114626
"Chr10","6391976","G","A",53,44,97,160,90,75,165,160,0.454545454545455,0.45360824742268,0.545801526717557,0.00093720712277412
"Chr10","6392100","T","C",73,62,135,144,91,85,176,144,0.482954545454545,0.459259259259259,0.527331189710611,0.0236952861952862
"Chr10","6393407","A","G",14,25,39,145,27,30,57,145,0.526315789473684,0.641025641025641,0.427083333333333,-0.114709851551957
"Chr10","6393546","T","C",12,17,29,160,21,18,39,160,0.461538461538462,0.586206896551724,0.485294117647059,-0.124668435013263
"Chr10","6394311","C","A",61,57,118,160,64,53,117,160,0.452991452991453,0.483050847457627,0.531914893617021,-0.0300593944661741
"Chr10","6395737","A","C",37,53,90,160,53,50,103,160,0.485436893203884,0.588888888888889,0.466321243523316,-0.103451995685005
"Chr10","6395973","T","A",77,71,148,138,101,103,204,138,0.504901960784314,0.47972972972973,0.505681818181818,0.025172231054584
"Chr10","6397251","C","T",53,60,113,144,61,62,123,144,0.504065040650406,0.530973451327434,0.483050847457627,-0.0269084106770272
"Chr10","6397598","A","T",51,41,92,145,58,71,129,145,0.550387596899225,0.445652173913043,0.493212669683258,0.104735422986181
"Chr10","6397817","T","C",72,52,124,160,67,88,155,160,0.567741935483871,0.419354838709677,0.498207885304659,0.148387096774194
"Chr10","6397968","A","C",45,38,83,160,70,54,124,160,0.435483870967742,0.457831325301205,0.555555555555556,-0.0223474543334629
"Chr10","6398427","T","C",69,49,118,140,58,79,137,140,0.576642335766423,0.415254237288136,0.498039215686275,0.161388098478288
"Chr10","6398528","G","A",64,50,114,160,73,77,150,160,0.513333333333333,0.43859649122807,0.518939393939394,0.0747368421052632
"Chr10","6398607","G","C",77,56,133,160,82,76,158,160,0.481012658227848,0.421052631578947,0.54639175257732,0.0599600266489008
"Chr10","6398796","T","G",47,51,98,144,49,65,114,144,0.570175438596491,0.520408163265306,0.452830188679245,0.0497672753311851
"Chr10","6398803","G","A",44,52,96,146,52,65,117,146,0.555555555555556,0.541666666666667,0.450704225352113,0.013888888888889
"Chr10","6399887","A","C",43,31,74,147,47,52,99,147,0.525252525252525,0.418918918918919,0.520231213872832,0.106333606333606
"Chr10","6399925","C","T",40,35,75,141,52,53,105,141,0.504761904761905,0.466666666666667,0.511111111111111,0.0380952380952381
"Chr10","6400008","T","C",28,39,67,143,43,37,80,143,0.4625,0.582089552238806,0.482993197278912,-0.119589552238806
"Chr10","6400161","A","G",31,43,74,139,48,44,92,139,0.478260869565217,0.581081081081081,0.475903614457831,-0.102820211515864
"Chr10","6400176","G","C",28,45,73,160,51,43,94,160,0.457446808510638,0.616438356164384,0.473053892215569,-0.158991547653745
"Chr10","6400184","C","T",29,44,73,160,52,42,94,160,0.446808510638298,0.602739726027397,0.48502994011976,-0.155931215389099
"Chr10","6400202","G","C",35,43,78,160,55,52,107,160,0.485981308411215,0.551282051282051,0.486486486486487,-0.0653007428708364
"Chr10","6400300","G","A",45,33,78,160,53,53,106,160,0.5,0.423076923076923,0.532608695652174,0.0769230769230769
"Chr10","6400385","A","G",41,34,75,160,39,49,88,160,0.556818181818182,0.453333333333333,0.49079754601227,0.103484848484848
"Chr10","6400624","G","T",57,76,133,160,77,87,164,160,0.530487804878049,0.571428571428571,0.451178451178451,-0.0409407665505226
"Chr10","6400747","C","A",72,52,124,138,94,82,176,138,0.465909090909091,0.419354838709677,0.553333333333333,0.0465542521994134
"Chr10","6402880","G","C",60,39,99,141,79,76,155,141,0.490322580645161,0.393939393939394,0.547244094488189,0.0963831867057673
"Chr10","6402992","G","C",39,23,62,160,58,45,103,160,0.436893203883495,0.370967741935484,0.587878787878788,0.0659254619480112
"Chr10","6403775","C","T",35,27,62,142,37,19,56,142,0.339285714285714,0.435483870967742,0.610169491525424,-0.0961981566820276
"Chr10","6403795","A","T",36,27,63,160,47,19,66,160,0.287878787878788,0.428571428571429,0.643410852713178,-0.140692640692641
"Chr10","6405262","T","C",7,6,13,137,16,12,28,160,0.428571428571429,0.461538461538462,0.560975609756098,-0.032967032967033
"Chr10","6405279","C","T",12,7,19,140,14,12,26,152,0.461538461538462,0.368421052631579,0.577777777777778,0.0931174089068826
"Chr10","6409735","T","C",25,25,50,148,27,28,55,148,0.509090909090909,0.5,0.495238095238095,0.00909090909090904
"Chr10","6411391","A","T",26,30,56,143,53,26,79,143,0.329113924050633,0.535714285714286,0.585185185185185,-0.206600361663653
"Chr10","6411739","G","A",34,22,56,160,34,21,55,160,0.381818181818182,0.392857142857143,0.612612612612613,-0.011038961038961
"Chr10","6411918","A","G",25,31,56,140,40,31,71,140,0.436619718309859,0.553571428571429,0.511811023622047,-0.116951710261569
"Chr10","6411957","G","T",25,30,55,143,44,24,68,143,0.352941176470588,0.545454545454545,0.560975609756098,-0.192513368983957
"Chr10","6413218","C","T",28,27,55,160,40,28,68,160,0.411764705882353,0.490909090909091,0.552845528455285,-0.079144385026738
"Chr10","6413382","A","G",58,31,89,160,40,53,93,160,0.56989247311828,0.348314606741573,0.538461538461538,0.221577866376707
"Chr10","6413479","T","G",49,25,74,160,37,48,85,160,0.564705882352941,0.337837837837838,0.540880503144654,0.226868044515103
"Chr10","6414276","A","G",22,28,50,144,16,15,31,144,0.483870967741935,0.56,0.469135802469136,-0.0761290322580646
"Chr10","6414296","C","G",15,31,46,160,15,14,29,160,0.482758620689655,0.673913043478261,0.4,-0.191154422788606
"Chr10","6414334","T","C",18,28,46,160,15,20,35,160,0.571428571428571,0.608695652173913,0.407407407407407,-0.0372670807453417
"Chr10","6414345","C","T",19,27,46,147,15,22,37,147,0.594594594594595,0.58695652173913,0.409638554216867,0.00763807285546414
"Chr10","6414419","T","C",13,18,31,160,19,21,40,160,0.525,0.580645161290323,0.450704225352113,-0.0556451612903226
"Chr10","6414671","A","G",9,10,19,145,17,7,24,49,0.291666666666667,0.526315789473684,0.604651162790698,-0.234649122807017
"Chr10","6416609","C","T",20,11,31,160,16,16,32,160,0.5,0.354838709677419,0.571428571428571,0.145161290322581
"Chr10","6416667","C","T",16,13,29,142,26,18,44,142,0.409090909090909,0.448275862068966,0.575342465753425,-0.0391849529780564
"Chr10","6418152","A","G",21,15,36,142,13,24,37,142,0.648648648648649,0.416666666666667,0.465753424657534,0.231981981981982
"Chr10","6419318","A","G",45,36,81,160,48,52,100,160,0.52,0.444444444444444,0.513812154696133,0.0755555555555556
"Chr10","6419681","A","G",66,36,102,160,67,64,131,160,0.488549618320611,0.352941176470588,0.570815450643777,0.135608441850022
"Chr10","6419697","T","A",63,39,102,145,67,67,134,145,0.5,0.382352941176471,0.550847457627119,0.117647058823529
"Chr10","6420579","C","T",34,42,76,155,69,74,143,155,0.517482517482518,0.552631578947368,0.470319634703196,-0.035149061464851
"Chr10","6420700","C","T",41,50,91,152,55,86,141,152,0.609929078014184,0.549450549450549,0.413793103448276,0.0604785285636349
"Chr10","6420710","G","T",41,41,82,146,53,70,123,146,0.569105691056911,0.5,0.458536585365854,0.0691056910569106
"Chr10","6420777","C","A",65,59,124,160,70,81,151,160,0.536423841059603,0.475806451612903,0.490909090909091,0.0606173894466994
"Chr10","6420922","C","T",66,40,106,160,84,76,160,160,0.475,0.377358490566038,0.56390977443609,0.0976415094339622
"Chr10","6421338","C","G",60,34,94,160,48,52,100,160,0.52,0.361702127659574,0.556701030927835,0.158297872340426
"Chr10","6421346","A","T",63,37,100,160,51,51,102,160,0.5,0.37,0.564356435643564,0.13
"Chr10","6421849","G","T",19,14,33,160,16,18,34,160,0.529411764705882,0.424242424242424,0.522388059701492,0.105169340463458
"Chr10","6422852","A","T",80,63,143,139,81,63,144,139,0.4375,0.440559440559441,0.560975609756098,-0.00305944055944057
"Chr10","6424581","G","A",36,26,62,160,49,64,113,160,0.566371681415929,0.419354838709677,0.485714285714286,0.147016842706252
"Chr10","6424672","C","T",45,39,84,160,40,55,95,160,0.578947368421053,0.464285714285714,0.474860335195531,0.114661654135338
"Chr10","6426594","C","G",57,53,110,160,59,57,116,160,0.491379310344828,0.481818181818182,0.513274336283186,0.00956112852664576
"Chr10","6427984","G","A",104,92,196,160,98,109,207,160,0.526570048309179,0.469387755102041,0.501240694789082,0.0571822932071379
"Chr10","6429244","G","T",89,71,160,150,74,97,171,150,0.567251461988304,0.44375,0.492447129909366,0.123501461988304
"Chr10","6435670","C","T",41,51,92,160,57,42,99,160,0.424242424242424,0.554347826086957,0.513089005235602,-0.130105401844532
"Chr10","6437275","T","C",54,45,99,160,62,50,112,160,0.446428571428571,0.454545454545455,0.549763033175355,-0.00811688311688308
"Chr10","6437559","A","G",63,69,132,160,70,72,142,160,0.507042253521127,0.522727272727273,0.485401459854015,-0.015685019206146
"Chr10","6437668","G","A",30,29,59,142,48,50,98,142,0.510204081632653,0.491525423728814,0.496815286624204,0.0186786579038395
"Chr10","6437742","T","C",36,44,80,143,65,61,126,143,0.484126984126984,0.55,0.490291262135922,-0.0658730158730159
"Chr10","6438700","G","C",64,61,125,137,94,74,168,137,0.44047619047619,0.488,0.539249146757679,-0.0475238095238095
"Chr10","6438736","G","T",60,71,131,136,108,88,196,136,0.448979591836735,0.541984732824427,0.513761467889908,-0.0930051409876928
"Chr10","6438850","G","A",54,61,115,144,86,60,146,144,0.410958904109589,0.530434782608696,0.53639846743295,-0.119475878499107
"Chr10","6439080","A","G",65,69,134,136,96,104,200,136,0.52,0.514925373134328,0.482035928143713,0.00507462686567162
"Chr10","6439350","A","C",45,54,99,142,81,70,151,142,0.463576158940397,0.545454545454545,0.504,-0.0818783865141481
"Chr10","6439678","T","G",36,31,67,151,72,48,120,151,0.4,0.462686567164179,0.577540106951872,-0.0626865671641791
"Chr10","6439709","A","C",35,37,72,139,64,40,104,139,0.384615384615385,0.513888888888889,0.5625,-0.129273504273504
"Chr10","6440207","A","G",40,17,57,160,40,35,75,160,0.466666666666667,0.298245614035088,0.606060606060606,0.168421052631579
"Chr10","6440256","A","C",28,18,46,160,54,38,92,160,0.41304347826087,0.391304347826087,0.594202898550725,0.0217391304347826
"Chr10","6440441","C","T",13,4,17,82,16,12,28,160,0.428571428571429,0.235294117647059,0.644444444444444,0.19327731092437
"Chr10","6440505","C","T",10,12,22,149,13,11,24,149,0.458333333333333,0.545454545454545,0.5,-0.0871212121212121
"Chr10","6443582","C","A",29,30,59,160,44,26,70,160,0.371428571428571,0.508474576271186,0.565891472868217,-0.137046004842615
"Chr10","6443645","T","C",39,50,89,140,52,39,91,140,0.428571428571429,0.561797752808989,0.505555555555556,-0.13322632423756
"Chr10","6443706","C","T",39,47,86,160,67,28,95,160,0.294736842105263,0.546511627906977,0.585635359116022,-0.251774785801714
"Chr10","6444747","T","A",48,46,94,160,59,50,109,160,0.458715596330275,0.48936170212766,0.527093596059113,-0.0306461057973843
"Chr10","6444921","C","G",47,48,95,141,60,50,110,141,0.454545454545455,0.505263157894737,0.521951219512195,-0.0507177033492823
"Chr10","6448015","T","C",54,39,93,160,73,51,124,160,0.411290322580645,0.419354838709677,0.585253456221198,-0.00806451612903225
"Chr10","6448674","T","C",47,67,114,160,78,54,132,160,0.409090909090909,0.587719298245614,0.508130081300813,-0.178628389154705
"Chr10","6449118","G","A",44,74,118,160,50,69,119,160,0.579831932773109,0.627118644067797,0.39662447257384,-0.0472867112946873
"Chr10","6450036","C","T",34,48,82,141,53,63,116,141,0.543103448275862,0.585365853658537,0.439393939393939,-0.0422624053826745
"Chr10","6450450","A","G",53,49,102,145,46,58,104,145,0.557692307692308,0.480392156862745,0.480582524271845,0.0773001508295626
"Chr10","6451241","C","T",31,43,74,142,30,44,74,142,0.594594594594595,0.581081081081081,0.412162162162162,0.0135135135135136
"Chr10","6451604","C","T",21,28,49,143,15,39,54,143,0.722222222222222,0.571428571428571,0.349514563106796,0.150793650793651
"Chr10","6452276","C","G",62,84,146,140,67,65,132,140,0.492424242424242,0.575342465753425,0.464028776978417,-0.0829182233291822
"Chr10","6452298","G","A",57,74,131,143,66,54,120,143,0.45,0.564885496183206,0.49003984063745,-0.114885496183206
"Chr10","6452381","G","T",55,68,123,160,63,68,131,160,0.519083969465649,0.552845528455285,0.464566929133858,-0.0337615589896357
"Chr10","6452418","C","T",65,54,119,147,70,59,129,147,0.457364341085271,0.453781512605042,0.544354838709677,0.00358282848022928
"Chr10","6452442","C","T",56,44,100,160,62,53,115,160,0.460869565217391,0.44,0.548837209302326,0.0208695652173913
"Chr10","6452654","C","T",64,56,120,139,84,84,168,139,0.5,0.466666666666667,0.513888888888889,0.0333333333333333
"Chr10","6452671","T","G",65,63,128,160,90,85,175,160,0.485714285714286,0.4921875,0.511551155115512,-0.00647321428571429
"Chr10","6452709","G","T",55,56,111,160,79,80,159,160,0.50314465408805,0.504504504504504,0.496296296296296,-0.00135985041645414
"Chr10","6452785","C","G",47,66,113,160,77,87,164,160,0.530487804878049,0.584070796460177,0.447653429602888,-0.0535829915821282
"Chr10","6452821","G","A",49,61,110,160,74,84,158,160,0.531645569620253,0.554545454545455,0.458955223880597,-0.0228998849252015
"Chr10","6452924","A","G",73,59,132,160,77,62,139,160,0.446043165467626,0.446969696969697,0.553505535055351,-0.00092653150207106
"Chr10","6453039","C","A",70,66,136,160,85,92,177,160,0.519774011299435,0.485294117647059,0.495207667731629,0.0344798936523762
"Chr10","6453249","G","A",66,73,139,160,61,59,120,160,0.491666666666667,0.525179856115108,0.49034749034749,-0.0335131894484412
"Chr10","6453266","T","C",65,72,137,146,60,56,116,146,0.482758620689655,0.525547445255474,0.494071146245059,-0.0427888245658193
"Chr10","6453335","C","T",46,58,104,160,56,60,116,160,0.517241379310345,0.557692307692308,0.463636363636364,-0.0404509283819628
"Chr10","6453480","A","G",54,83,137,150,67,77,144,150,0.534722222222222,0.605839416058394,0.430604982206406,-0.071117193836172
"Chr10","6453505","A","G",61,68,129,149,67,61,128,149,0.4765625,0.527131782945736,0.498054474708171,-0.0505692829457365
"Chr10","6453547","A","G",71,80,151,160,75,62,137,160,0.452554744525547,0.529801324503311,0.506944444444444,-0.0772465799777639
"Chr10","6453556","C","G",69,87,156,160,71,61,132,160,0.462121212121212,0.557692307692308,0.486111111111111,-0.0955710955710956
"Chr10","6453640","G","C",76,70,146,160,86,75,161,160,0.46583850931677,0.479452054794521,0.527687296416938,-0.0136135454777503
"Chr10","6453648","T","C",81,69,150,160,93,72,165,160,0.436363636363636,0.46,0.552380952380952,-0.0236363636363637
"Chr10","6453967","T","G",56,74,130,160,61,77,138,160,0.557971014492754,0.569230769230769,0.436567164179104,-0.0112597547380155
"Chr10","6453980","A","C",50,68,118,141,60,76,136,141,0.558823529411765,0.576271186440678,0.433070866141732,-0.0174476570289133
"Chr10","6454031","A","G",45,62,107,160,68,65,133,160,0.488721804511278,0.579439252336449,0.470833333333333,-0.0907174478251704
"Chr10","6454085","T","C",48,57,105,139,62,48,110,139,0.436363636363636,0.542857142857143,0.511627906976744,-0.106493506493506
"Chr10","6454186","A","G",68,83,151,160,93,82,175,160,0.468571428571429,0.549668874172185,0.493865030674847,-0.0810974456007569
"Chr10","6454294","T","C",27,54,81,139,69,41,110,139,0.372727272727273,0.666666666666667,0.50261780104712,-0.293939393939394
"Chr10","6454310","G","A",27,55,82,141,71,40,111,141,0.36036036036036,0.670731707317073,0.507772020725389,-0.310371346956713
"Chr10","6454317","A","T",27,54,81,143,66,40,106,143,0.377358490566038,0.666666666666667,0.497326203208556,-0.289308176100629
"Chr10","6454341","T","G",25,57,82,139,62,45,107,139,0.420560747663551,0.695121951219512,0.46031746031746,-0.274561203555961
"Chr10","6454465","T","C",38,31,69,137,56,57,113,137,0.504424778761062,0.449275362318841,0.516483516483517,0.0551494164422214
"Chr10","6454481","T","C",34,33,67,160,60,58,118,160,0.491525423728814,0.492537313432836,0.508108108108108,-0.00101188970402222
"Chr10","6454602","C","T",25,28,53,139,53,24,77,139,0.311688311688312,0.528301886792453,0.6,-0.216613575104141
"Chr10","6454608","T","C",26,25,51,160,52,24,76,160,0.315789473684211,0.490196078431373,0.614173228346457,-0.174406604747162
"Chr10","6454619","A","G",25,26,51,140,52,24,76,140,0.315789473684211,0.509803921568627,0.606299212598425,-0.194014447884417
"Chr10","6454641","G","A",26,28,54,160,52,27,79,160,0.341772151898734,0.518518518518518,0.586466165413534,-0.176746366619784
"Chr10","6454784","G","A",28,35,63,160,60,42,102,160,0.411764705882353,0.555555555555556,0.533333333333333,-0.143790849673203
"Chr10","6454827","C","A",30,32,62,143,55,36,91,143,0.395604395604396,0.516129032258065,0.555555555555556,-0.120524636653669
"Chr10","6454869","C","T",24,21,45,160,39,36,75,160,0.48,0.466666666666667,0.525,0.0133333333333333
"Chr10","6462976","C","T",56,54,110,157,70,39,109,157,0.357798165137615,0.490909090909091,0.575342465753425,-0.133110925771476
"Chr10","6464361","C","A",79,90,169,160,106,104,210,160,0.495238095238095,0.532544378698225,0.488126649076517,-0.0373062834601297
"Chr10","6465004","G","T",46,67,113,160,64,62,126,160,0.492063492063492,0.592920353982301,0.460251046025105,-0.100856861918809
"Chr10","6465460","C","G",36,59,95,160,61,63,124,160,0.508064516129032,0.621052631578947,0.442922374429224,-0.112988115449915
"Chr10","6465880","G","A",43,43,86,160,44,39,83,160,0.469879518072289,0.5,0.514792899408284,-0.0301204819277108
"Chr10","6465915","T","G",42,41,83,143,45,32,77,143,0.415584415584416,0.493975903614458,0.54375,-0.0783914880300422
"Chr10","6465928","T","C",37,37,74,160,34,28,62,160,0.451612903225806,0.5,0.522058823529412,-0.0483870967741936
"Chr10","6465935","G","A",35,35,70,160,29,25,54,160,0.462962962962963,0.5,0.516129032258065,-0.037037037037037
"Chr10","6466422","T","C",34,40,74,142,38,36,74,142,0.486486486486487,0.540540540540541,0.486486486486487,-0.0540540540540541
"Chr10","6466432","A","C",34,42,76,160,39,36,75,160,0.48,0.552631578947368,0.483443708609272,-0.0726315789473685
"Chr10","6466634","A","C",45,43,88,155,38,36,74,155,0.486486486486487,0.488636363636364,0.512345679012346,-0.00214987714987713
"Chr10","6466761","A","T",45,67,112,142,65,37,102,142,0.362745098039216,0.598214285714286,0.514018691588785,-0.23546918767507
"Chr10","6466805","G","A",50,78,128,160,85,50,135,160,0.37037037037037,0.609375,0.513307984790874,-0.23900462962963
"Chr10","6466895","A","G",56,62,118,160,90,75,165,160,0.454545454545455,0.525423728813559,0.515901060070671,-0.0708782742681048
"Chr10","6466914","G","A",51,76,127,160,93,82,175,160,0.468571428571429,0.598425196850394,0.47682119205298,-0.129853768278965
"Chr10","6466960","C","T",41,76,117,160,68,74,142,160,0.52112676056338,0.64957264957265,0.420849420849421,-0.128445889009269
"Chr10","6466968","G","C",40,77,117,142,71,70,141,142,0.49645390070922,0.658119658119658,0.430232558139535,-0.161665757410438
"Chr10","6467006","T","A",35,77,112,155,73,78,151,155,0.516556291390728,0.6875,0.4106463878327,-0.170943708609272
"Chr10","6467118","G","C",50,73,123,141,86,63,149,141,0.422818791946309,0.59349593495935,0.5,-0.170677143013041
"Chr10","6467147","C","T",56,82,138,160,90,66,156,160,0.423076923076923,0.594202898550725,0.496598639455782,-0.171125975473802
"Chr10","6467296","G","A",63,64,127,145,60,90,150,145,0.6,0.503937007874016,0.444043321299639,0.0960629921259842
"Chr10","6467340","G","A",60,57,117,139,66,90,156,139,0.576923076923077,0.487179487179487,0.461538461538462,0.0897435897435897
"Chr10","6467454","G","T",51,49,100,160,65,68,133,160,0.511278195488722,0.49,0.497854077253219,0.0212781954887218
"Chr10","6467484","T","G",52,73,125,160,71,71,142,160,0.5,0.584,0.460674157303371,-0.084
"Chr10","6467540","A","T",50,86,136,160,67,75,142,160,0.528169014084507,0.632352941176471,0.420863309352518,-0.104183927091964
"Chr10","6467663","A","T",42,71,113,160,64,87,151,160,0.576158940397351,0.628318584070796,0.401515151515151,-0.0521596436734455
"Chr10","6468082","T","A",39,65,104,160,70,59,129,160,0.457364341085271,0.625,0.467811158798283,-0.167635658914729
"Chr10","6468103","C","T",49,65,114,139,63,64,127,139,0.503937007874016,0.570175438596491,0.464730290456432,-0.0662384307224755
"Chr10","6468183","A","G",76,81,157,138,91,79,170,138,0.464705882352941,0.515923566878981,0.510703363914373,-0.0512176845260397
"Chr10","6468237","T","C",73,85,158,160,95,76,171,160,0.444444444444444,0.537974683544304,0.51063829787234,-0.0935302390998594
"Chr10","6468277","G","A",71,77,148,138,107,67,174,138,0.385057471264368,0.52027027027027,0.552795031055901,-0.135212799005902
"Chr10","6468288","G","T",70,79,149,160,110,69,179,160,0.385474860335196,0.530201342281879,0.548780487804878,-0.144726481946684
"Chr10","6468311","G","A",62,67,129,160,103,65,168,160,0.386904761904762,0.51937984496124,0.555555555555556,-0.132475083056478
"Chr10","6468380","C","T",58,66,124,160,93,66,159,160,0.415094339622642,0.532258064516129,0.53356890459364,-0.117163724893487
"Chr10","6468447","A","G",64,53,117,160,89,67,156,160,0.429487179487179,0.452991452991453,0.56043956043956,-0.0235042735042735
"Chr10","6468455","A","G",58,52,110,141,79,61,140,141,0.435714285714286,0.472727272727273,0.548,-0.037012987012987
"Chr10","6468563","G","A",84,59,143,160,97,81,178,160,0.455056179775281,0.412587412587413,0.56386292834891,0.0424687671878683
"Chr10","6468580","T","A",66,54,120,143,86,79,165,143,0.478787878787879,0.45,0.533333333333333,0.0287878787878788
"Chr10","6468602","G","A",67,51,118,160,93,72,165,160,0.436363636363636,0.432203389830508,0.565371024734982,0.00416024653312785
"Chr10","6468619","T","A",71,60,131,160,107,76,183,160,0.415300546448087,0.458015267175573,0.56687898089172,-0.0427147207274851
"Chr10","6468690","C","A",72,83,155,137,115,85,200,137,0.425,0.535483870967742,0.526760563380282,-0.110483870967742
"Chr10","6468733","T","A",83,75,158,142,113,75,188,142,0.398936170212766,0.474683544303797,0.566473988439306,-0.0757473740910315
"Chr10","6468770","G","A",84,86,170,139,133,103,236,139,0.436440677966102,0.505882352941176,0.53448275862069,-0.0694416749750748
"Chr10","6468776","T","C",82,81,163,160,130,100,230,160,0.434782608695652,0.496932515337423,0.539440203562341,-0.0621499066417712
"Chr10","6468871","T","G",50,67,117,139,109,65,174,139,0.373563218390805,0.572649572649573,0.54639175257732,-0.199086354258768
"Chr10","6468929","C","T",42,58,100,160,82,41,123,160,0.333333333333333,0.58,0.556053811659193,-0.246666666666667
"Chr10","6468940","C","T",43,52,95,160,81,41,122,160,0.336065573770492,0.547368421052632,0.571428571428571,-0.21130284728214
"Chr10","6469033","C","T",66,66,132,139,95,77,172,139,0.447674418604651,0.5,0.529605263157895,-0.0523255813953488
"Chr10","6469098","A","G",65,71,136,160,87,61,148,160,0.412162162162162,0.522058823529412,0.535211267605634,-0.10989666136725
"Chr10","6469113","A","C",67,74,141,136,95,63,158,136,0.39873417721519,0.524822695035461,0.54180602006689,-0.126088517820271
"Chr10","6469242","T","C",76,72,148,136,126,94,220,136,0.427272727272727,0.486486486486487,0.548913043478261,-0.0592137592137593
"Chr10","6469310","T","C",64,60,124,137,109,79,188,137,0.420212765957447,0.483870967741935,0.55448717948718,-0.0636582017844887
"Chr10","6469316","G","A",62,58,120,160,103,77,180,160,0.427777777777778,0.483333333333333,0.55,-0.0555555555555556
"Chr10","6469343","T","C",64,57,121,160,86,55,141,160,0.390070921985816,0.471074380165289,0.572519083969466,-0.0810034581794736
"Chr10","6469442","T","A",71,61,132,160,84,72,156,160,0.461538461538462,0.462121212121212,0.538194444444444,-0.000582750582750535
"Chr10","6469508","G","T",45,52,97,160,71,74,145,160,0.510344827586207,0.536082474226804,0.479338842975207,-0.0257376466405972
"Chr10","6469516","T","C",42,49,91,141,65,76,141,141,0.539007092198582,0.538461538461538,0.461206896551724,0.000545553737043125
"Chr10","6469536","T","C",44,45,89,142,64,78,142,142,0.549295774647887,0.50561797752809,0.467532467532468,0.0436777971197975
"Chr10","6469563","T","C",39,49,88,152,58,67,125,152,0.536,0.556818181818182,0.455399061032864,-0.0208181818181817
"Chr10","6469580","G","A",44,44,88,158,69,61,130,158,0.469230769230769,0.5,0.518348623853211,-0.0307692307692308
"Chr10","6469746","T","C",43,43,86,149,60,43,103,149,0.41747572815534,0.5,0.544973544973545,-0.0825242718446602
"Chr10","6469760","A","C",42,47,89,160,54,48,102,160,0.470588235294118,0.528089887640449,0.50261780104712,-0.0575016523463318
"Chr10","6469988","T","C",23,11,34,144,32,20,52,144,0.384615384615385,0.323529411764706,0.63953488372093,0.0610859728506787
"Chr10","6470340","C","T",12,10,22,160,21,11,32,160,0.34375,0.454545454545455,0.611111111111111,-0.110795454545455
"Chr10","6470460","T","C",8,9,17,148,18,12,30,148,0.4,0.529411764705882,0.553191489361702,-0.129411764705882
"Chr10","6470649","T","A",13,20,33,160,28,27,55,160,0.490909090909091,0.606060606060606,0.465909090909091,-0.115151515151515
"Chr10","6470654","T","A",13,20,33,160,34,30,64,160,0.46875,0.606060606060606,0.484536082474227,-0.137310606060606
"Chr10","6471757","G","C",19,21,40,160,25,17,42,160,0.404761904761905,0.525,0.536585365853659,-0.120238095238095
"Chr10","6495921","A","C",51,44,95,142,52,55,107,142,0.514018691588785,0.463157894736842,0.50990099009901,0.0508607968519429
"Chr10","6496913","G","T",42,15,57,160,38,39,77,160,0.506493506493506,0.263157894736842,0.597014925373134,0.243335611756664
"Chr10","6497172","G","T",55,52,107,160,56,77,133,160,0.578947368421053,0.485981308411215,0.4625,0.0929660600098377
"Chr10","6497236","C","A",47,41,88,160,46,68,114,160,0.596491228070175,0.465909090909091,0.46039603960396,0.130582137161085
"Chr10","6498009","G","T",45,33,78,160,55,44,99,160,0.444444444444444,0.423076923076923,0.564971751412429,0.0213675213675213
"Chr10","6498771","C","T",64,52,116,139,94,82,176,139,0.465909090909091,0.448275862068966,0.541095890410959,0.0176332288401254
"Chr10","6499644","C","T",71,71,142,141,81,71,152,141,0.467105263157895,0.5,0.517006802721088,-0.0328947368421053
"Chr10","6499663","T","G",71,80,151,160,83,74,157,160,0.471337579617834,0.529801324503311,0.5,-0.0584637448854769
"Chr10","6499698","C","G",77,82,159,145,95,70,165,145,0.424242424242424,0.515723270440252,0.530864197530864,-0.0914808461978273
"Chr10","6500072","C","T",83,67,150,160,87,100,187,160,0.53475935828877,0.446666666666667,0.504451038575668,0.0880926916221034
"Chr10","6500221","C","T",71,73,144,144,81,96,177,144,0.542372881355932,0.506944444444444,0.473520249221184,0.0354284369114878
"Chr10","6500894","A","T",113,80,193,140,111,119,230,140,0.517391304347826,0.414507772020725,0.529550827423168,0.102883532327101
"Chr10","6501027","C","A",110,92,202,160,126,122,248,160,0.491935483870968,0.455445544554455,0.524444444444444,0.0364899393165123
"Chr10","6501199","A","G",68,59,127,160,64,113,177,160,0.638418079096045,0.464566929133858,0.434210526315789,0.173851149962187
"Chr10","6501256","G","C",83,71,154,158,95,130,225,158,0.577777777777778,0.461038961038961,0.469656992084433,0.116738816738817
"Chr10","6501286","G","A",76,72,148,160,99,119,218,160,0.545871559633027,0.486486486486487,0.478142076502732,0.059385073146541
"Chr10","6501942","G","A",34,48,82,143,58,60,118,143,0.508474576271186,0.585365853658537,0.46,-0.0768912773873501
"Chr10","6501965","A","C",49,43,92,142,65,59,124,142,0.475806451612903,0.467391304347826,0.527777777777778,0.00841514726507714
"Chr10","6503384","C","G",50,23,73,160,56,45,101,160,0.445544554455446,0.315068493150685,0.609195402298851,0.130476061304761
"Chr10","6503392","A","T",52,24,76,160,57,46,103,160,0.446601941747573,0.315789473684211,0.608938547486033,0.130812468063362
"Chr10","6503476","G","C",37,26,63,160,45,48,93,160,0.516129032258065,0.412698412698413,0.525641025641026,0.103430619559652
"Chr10","6503566","G","A",17,28,45,149,36,47,83,149,0.566265060240964,0.622222222222222,0.4140625,-0.0559571619812583
"Chr10","6503592","T","C",20,17,37,160,28,31,59,160,0.525423728813559,0.459459459459459,0.5,0.0659642693540999
"Chr10","6504171","A","C",21,15,36,160,20,18,38,160,0.473684210526316,0.416666666666667,0.554054054054054,0.0570175438596491
"Chr10","6504417","A","C",6,6,12,142,16,17,33,160,0.515151515151515,0.5,0.488888888888889,0.0151515151515151
"Chr10","6504488","T","C",5,7,12,135,9,10,19,145,0.526315789473684,0.583333333333333,0.451612903225806,-0.0570175438596492
"Chr10","6505773","C","T",20,13,33,147,28,25,53,147,0.471698113207547,0.393939393939394,0.558139534883721,0.0777587192681533
"Chr10","6505993","G","T",49,56,105,144,61,60,121,144,0.495867768595041,0.533333333333333,0.486725663716814,-0.037465564738292
"Chr10","6511364","C","A",69,66,135,136,82,82,164,136,0.5,0.488888888888889,0.505016722408027,0.0111111111111111
"Chr10","6512674","T","C",62,52,114,140,87,57,144,140,0.395833333333333,0.456140350877193,0.577519379844961,-0.0603070175438596
"Chr10","6513293","A","T",59,54,113,160,78,71,149,160,0.476510067114094,0.47787610619469,0.522900763358779,-0.00136603908059635
"Chr10","6514720","A","G",80,42,122,160,77,86,163,160,0.52760736196319,0.344262295081967,0.550877192982456,0.183345066881223
"Chr10","6515168","A","G",45,43,88,144,35,50,85,144,0.588235294117647,0.488636363636364,0.46242774566474,0.0995989304812834
"Chr10","6515194","G","C",53,43,96,136,42,54,96,136,0.5625,0.447916666666667,0.494791666666667,0.114583333333333
"Chr10","6516360","G","A",58,60,118,138,68,68,136,138,0.5,0.508474576271186,0.496062992125984,-0.00847457627118642
"Chr10","6516385","A","G",65,57,122,160,74,68,142,160,0.47887323943662,0.467213114754098,0.526515151515151,0.0116601246825213
"Chr10","6516792","G","A",42,28,70,160,36,45,81,160,0.555555555555556,0.4,0.516556291390728,0.155555555555556
"Chr10","6517140","A","G",67,30,97,160,50,55,105,160,0.523809523809524,0.309278350515464,0.579207920792079,0.21453117329406
"Chr10","6517205","C","T",43,40,83,144,62,54,116,144,0.46551724137931,0.481927710843373,0.527638190954774,-0.0164104694640632
"Chr10","6517244","T","G",37,41,78,140,57,47,104,140,0.451923076923077,0.525641025641026,0.516483516483517,-0.0737179487179487
"Chr10","6535898","G","A",56,78,134,138,109,94,203,138,0.463054187192118,0.582089552238806,0.489614243323442,-0.119035365046688
"Chr10","6559675","A","G",59,76,135,160,74,89,163,160,0.54601226993865,0.562962962962963,0.446308724832215,-0.0169506930243127
"Chr10","6584490","G","A",26,16,42,146,34,26,60,146,0.433333333333333,0.380952380952381,0.588235294117647,0.0523809523809524
"Chr10","6589464","G","A",19,21,40,160,24,18,42,160,0.428571428571429,0.525,0.524390243902439,-0.0964285714285715
"Chr10","6740751","C","T",25,24,49,160,34,23,57,160,0.403508771929825,0.489795918367347,0.556603773584906,-0.0862871464375224
"Chr10","6740763","A","T",24,23,47,160,26,26,52,160,0.5,0.48936170212766,0.505050505050505,0.0106382978723404
"Chr10","6740796","A","G",19,23,42,160,22,24,46,160,0.521739130434783,0.547619047619048,0.465909090909091,-0.0258799171842651
"Chr10","6741103","A","G",28,15,43,160,10,22,32,160,0.6875,0.348837209302326,0.506666666666667,0.338662790697674
"Chr10","6741123","C","G",25,14,39,142,8,19,27,142,0.703703703703704,0.358974358974359,0.5,0.344729344729345
"Chr10","6741172","C","G",14,2,16,15,7,13,20,140,0.65,0.125,0.583333333333333,0.525
"Chr10","6741229","T","C",8,10,18,147,5,13,18,104,0.722222222222222,0.555555555555556,0.361111111111111,0.166666666666667
"Chr10","6741292","G","T",5,9,14,114,4,8,12,80,0.666666666666667,0.642857142857143,0.346153846153846,0.0238095238095237
"Chr10","6742198","C","A",13,19,32,141,23,24,47,141,0.51063829787234,0.59375,0.455696202531646,-0.0831117021276596
"Chr10","6742838","G","C",65,67,132,139,69,80,149,139,0.536912751677852,0.507575757575758,0.476868327402135,0.0293369941020948
"Chr10","6742878","G","T",46,51,97,160,56,64,120,160,0.533333333333333,0.525773195876289,0.470046082949309,0.00756013745704465
"Chr10","6743352","T","C",78,71,149,136,104,95,199,136,0.477386934673367,0.476510067114094,0.522988505747126,0.000876867559272909
"Chr10","6743664","G","A",53,53,106,160,89,56,145,160,0.386206896551724,0.5,0.565737051792829,-0.113793103448276
"Chr10","6744517","T","C",64,78,142,157,87,87,174,157,0.5,0.549295774647887,0.477848101265823,-0.0492957746478874
"Chr10","6744842","T","C",51,76,127,160,88,69,157,160,0.439490445859873,0.598425196850394,0.48943661971831,-0.158934750990521
"Chr10","6744862","G","A",69,48,117,140,70,81,151,140,0.536423841059603,0.41025641025641,0.51865671641791,0.126167430803192
"Chr10","6745042","C","T",37,40,77,160,37,43,80,160,0.5375,0.519480519480519,0.471337579617834,0.0180194805194805
"Chr10","6745109","G","A",38,51,89,160,43,59,102,160,0.57843137254902,0.573033707865168,0.424083769633508,0.00539766468385117
"Chr10","6745179","T","C",37,52,89,160,51,52,103,160,0.504854368932039,0.584269662921348,0.458333333333333,-0.0794152939893095
"Chr10","6745286","T","C",48,48,96,160,56,36,92,160,0.391304347826087,0.5,0.553191489361702,-0.108695652173913
"Chr10","6745727","A","T",35,28,63,139,54,52,106,139,0.490566037735849,0.444444444444444,0.526627218934911,0.0461215932914046
"Chr10","6746188","T","G",69,71,140,160,104,100,204,160,0.490196078431373,0.507142857142857,0.502906976744186,-0.0169467787114846
"Chr10","6746288","T","C",46,65,111,143,57,61,118,143,0.516949152542373,0.585585585585586,0.449781659388646,-0.0686364330432128
"Chr10","6746925","C","T",43,58,101,160,40,46,86,160,0.534883720930233,0.574257425742574,0.443850267379679,-0.0393737048123417
"Chr10","6747751","G","A",78,96,174,137,132,125,257,137,0.486381322957198,0.551724137931034,0.487238979118329,-0.065342814973836
"Chr10","6747830","C","G",65,99,164,160,107,87,194,160,0.448453608247423,0.603658536585366,0.480446927374302,-0.155204928337943
"Chr10","6747864","A","T",72,105,177,137,109,76,185,137,0.410810810810811,0.593220338983051,0.5,-0.18240952817224
"Chr10","6748368","T","C",87,90,177,136,117,96,213,136,0.450704225352113,0.508474576271186,0.523076923076923,-0.0577703509190737
"Chr10","6748592","C","T",77,90,167,160,91,71,162,160,0.438271604938272,0.538922155688623,0.51063829787234,-0.100650550750351
"Chr10","6748739","T","C",62,73,135,160,90,44,134,160,0.328358208955224,0.540740740740741,0.565055762081784,-0.212382531785517
"Chr10","6748806","G","A",78,61,139,141,86,60,146,141,0.410958904109589,0.438848920863309,0.575438596491228,-0.0278900167537203
"Chr10","6748863","C","T",68,60,128,160,87,66,153,160,0.431372549019608,0.46875,0.551601423487544,-0.0373774509803921
"Chr10","6748929","C","A",54,48,102,140,68,57,125,140,0.456,0.470588235294118,0.537444933920705,-0.0145882352941176
"Chr10","6749009","A","C",62,49,111,160,85,57,142,160,0.401408450704225,0.441441441441441,0.58102766798419,-0.0400329907372161
"Chr10","6749072","G","A",48,50,98,150,69,53,122,150,0.434426229508197,0.510204081632653,0.531818181818182,-0.0757778521244564
"Chr10","6749089","T","C",46,53,99,142,74,59,133,142,0.443609022556391,0.535353535353535,0.517241379310345,-0.0917445127971444
"Chr10","6749332","G","A",59,68,127,160,72,54,126,160,0.428571428571429,0.535433070866142,0.517786561264822,-0.106861642294713
"Chr10","6749341","T","C",62,60,122,141,72,47,119,141,0.394957983193277,0.491803278688525,0.556016597510373,-0.0968452954952473
"Chr10","6749498","T","C",38,49,87,160,57,68,125,160,0.544,0.563218390804598,0.44811320754717,-0.0192183908045976
"Chr10","6751336","T","G",36,36,72,160,58,39,97,160,0.402061855670103,0.5,0.556213017751479,-0.0979381443298969
"Chr10","6751626","C","G",72,57,129,143,76,80,156,143,0.512820512820513,0.441860465116279,0.519298245614035,0.0709600477042337
"Chr10","6753025","A","G",76,71,147,160,70,73,143,160,0.510489510489511,0.482993197278912,0.503448275862069,0.027496313210599
"Chr10","6753773","C","A",64,71,135,160,106,67,173,160,0.38728323699422,0.525925925925926,0.551948051948052,-0.138642688931706
"Chr10","6753855","T","G",68,66,134,160,83,62,145,160,0.427586206896552,0.492537313432836,0.541218637992832,-0.0649511065362841
"Chr10","6754460","A","T",56,76,132,148,74,77,151,148,0.509933774834437,0.575757575757576,0.459363957597173,-0.0658238009231387
"Chr10","6765990","G","A",39,29,68,141,52,38,90,141,0.422222222222222,0.426470588235294,0.575949367088608,-0.00424836601307188
"Chr10","6778475","G","A",51,36,87,151,73,56,129,151,0.434108527131783,0.413793103448276,0.574074074074074,0.0203154236835071
"Chr10","6778484","G","A",49,36,85,139,80,53,133,139,0.398496240601504,0.423529411764706,0.591743119266055,-0.0250331711632021
"Chr10","6778570","A","T",65,59,124,160,103,63,166,160,0.379518072289157,0.475806451612903,0.579310344827586,-0.0962883793237466
"Chr10","6778600","G","A",70,50,120,145,94,59,153,145,0.38562091503268,0.416666666666667,0.600732600732601,-0.0310457516339869
"Chr10","6778711","C","T",67,66,133,160,107,78,185,160,0.421621621621622,0.496240601503759,0.547169811320755,-0.0746189798821377
"Chr10","6778955","T","C",46,47,93,160,65,63,128,160,0.4921875,0.505376344086022,0.502262443438914,-0.0131888440860215
"Chr10","6778972","T","A",53,50,103,150,68,59,127,150,0.464566929133858,0.485436893203884,0.526086956521739,-0.0208699640700252
"Chr10","6779127","T","C",43,62,105,160,58,74,132,160,0.560606060606061,0.59047619047619,0.426160337552743,-0.0298701298701299
"Chr10","6779312","G","A",20,19,39,160,30,19,49,160,0.387755102040816,0.487179487179487,0.568181818181818,-0.0994243851386709
"Chr10","6779497","A","G",13,14,27,160,17,21,38,160,0.552631578947368,0.518518518518518,0.461538461538462,0.03411306042885
"Chr10","6780004","T","C",29,29,58,160,27,30,57,160,0.526315789473684,0.5,0.48695652173913,0.0263157894736842
"Chr10","6780369","C","A",24,31,55,160,40,25,65,160,0.384615384615385,0.563636363636364,0.533333333333333,-0.179020979020979
"Chr10","6780518","T","C",26,26,52,160,46,46,92,160,0.5,0.5,0.5,0
"Chr10","6780601","C","T",26,34,60,160,48,36,84,160,0.428571428571429,0.566666666666667,0.513888888888889,-0.138095238095238
"Chr10","6780664","A","G",20,29,49,142,46,29,75,142,0.386666666666667,0.591836734693878,0.532258064516129,-0.205170068027211
"Chr10","6780712","G","A",20,15,35,143,50,25,75,143,0.333333333333333,0.428571428571429,0.636363636363636,-0.0952380952380952
"Chr10","6780743","A","G",21,12,33,143,51,35,86,143,0.406976744186047,0.363636363636364,0.605042016806723,0.0433403805496829
"Chr10","6781139","A","G",26,37,63,140,68,32,100,140,0.32,0.587301587301587,0.576687116564417,-0.267301587301587
"Chr10","6781163","A","G",26,35,61,139,53,33,86,139,0.383720930232558,0.573770491803279,0.537414965986395,-0.190049561570721
"Chr10","6781286","C","T",28,39,67,152,37,39,76,152,0.513157894736842,0.582089552238806,0.454545454545455,-0.0689316575019638
"Chr10","6781300","T","C",30,37,67,146,38,41,79,146,0.518987341772152,0.552238805970149,0.465753424657534,-0.0332514641979974
"Chr10","6781320","C","A",30,40,70,142,38,38,76,142,0.5,0.571428571428571,0.465753424657534,-0.0714285714285714
"Chr10","6781343","A","G",33,41,74,160,43,32,75,160,0.426666666666667,0.554054054054054,0.51006711409396,-0.127387387387387
"Chr10","6781355","A","G",31,38,69,160,39,29,68,160,0.426470588235294,0.550724637681159,0.510948905109489,-0.124254049445865
"Chr10","6781405","T","G",22,43,65,151,36,28,64,151,0.4375,0.661538461538462,0.449612403100775,-0.224038461538462
"Chr10","6781558","C","T",20,26,46,149,29,30,59,149,0.508474576271186,0.565217391304348,0.466666666666667,-0.0567428150331614
"Chr10","6781632","T","C",25,21,46,142,21,24,45,142,0.533333333333333,0.456521739130435,0.505494505494505,0.0768115942028986
"Chr10","6781686","C","T",21,22,43,142,17,21,38,142,0.552631578947368,0.511627906976744,0.469135802469136,0.0410036719706243
"Chr10","6781704","C","T",19,23,42,146,21,17,38,146,0.447368421052632,0.547619047619048,0.5,-0.100250626566416
"Chr10","6781749","G","C",13,21,34,149,25,17,42,149,0.404761904761905,0.617647058823529,0.5,-0.212885154061625
"Chr10","6782158","T","C",19,37,56,160,38,34,72,160,0.472222222222222,0.660714285714286,0.4453125,-0.188492063492063
"Chr10","6782536","C","T",41,43,84,148,48,57,105,148,0.542857142857143,0.511904761904762,0.470899470899471,0.030952380952381
"Chr10","6782610","C","G",74,64,138,141,81,62,143,141,0.433566433566434,0.463768115942029,0.551601423487544,-0.0302016823755955
"Chr10","6782694","T","A",77,53,130,142,86,73,159,142,0.459119496855346,0.407692307692308,0.56401384083045,0.0514271891630382
"Chr10","6782750","C","T",53,55,108,160,81,75,156,160,0.480769230769231,0.509259259259259,0.507575757575758,-0.0284900284900285
"Chr10","6782764","T","G",43,50,93,160,72,73,145,160,0.503448275862069,0.537634408602151,0.483193277310924,-0.0341861327400815
"Chr10","6782827","C","T",39,59,98,160,68,48,116,160,0.413793103448276,0.602040816326531,0.5,-0.188247712878255
"Chr10","6782903","C","T",51,70,121,160,80,52,132,160,0.393939393939394,0.578512396694215,0.517786561264822,-0.184573002754821
"Chr10","6783345","C","G",20,24,44,160,35,33,68,160,0.485294117647059,0.545454545454545,0.491071428571429,-0.0601604278074866
"Chr10","6784490","A","G",64,60,124,140,49,62,111,140,0.558558558558559,0.483870967741935,0.480851063829787,0.074687590816623
"Chr10","6784515","A","G",61,48,109,144,53,58,111,144,0.522522522522523,0.440366972477064,0.518181818181818,0.0821555500454583
"Chr10","6784551","G","A",66,66,132,151,73,62,135,151,0.459259259259259,0.5,0.52059925093633,-0.0407407407407407
"Chr10","6784742","C","T",44,41,85,140,60,57,117,140,0.487179487179487,0.482352941176471,0.514851485148515,0.00482654600301657
"Chr10","6784767","A","G",48,44,92,139,60,54,114,139,0.473684210526316,0.478260869565217,0.524271844660194,-0.00457665903890164
"Chr10","6784821","A","G",39,34,73,160,52,54,106,160,0.509433962264151,0.465753424657534,0.508379888268156,0.0436805376066167
"Chr10","6785493","T","G",45,39,84,144,66,44,110,144,0.4,0.464285714285714,0.572164948453608,-0.0642857142857143
"Chr10","6785520","T","C",40,35,75,160,63,54,117,160,0.461538461538462,0.466666666666667,0.536458333333333,-0.00512820512820511
"Chr10","6785701","A","G",59,68,127,160,105,64,169,160,0.378698224852071,0.535433070866142,0.554054054054054,-0.156734846014071
"Chr10","6785823","T","C",57,68,125,160,104,58,162,160,0.358024691358025,0.544,0.560975609756098,-0.185975308641975
"Chr10","6786042","T","C",59,69,128,144,104,60,164,144,0.365853658536585,0.5390625,0.558219178082192,-0.173208841463415
"Chr10","6786115","C","T",99,81,180,136,135,89,224,136,0.397321428571429,0.45,0.579207920792079,-0.0526785714285715
"Chr10","6786128","G","A",100,72,172,160,119,88,207,160,0.42512077294686,0.418604651162791,0.577836411609499,0.00651612178406918
"Chr10","6786218","T","C",86,77,163,139,108,85,193,139,0.440414507772021,0.47239263803681,0.544943820224719,-0.0319781302647891
"Chr10","6786294","A","G",75,103,178,160,115,111,226,160,0.491150442477876,0.578651685393258,0.47029702970297,-0.0875012429153823
"Chr10","6788221","C","T",80,48,128,160,80,80,160,160,0.5,0.375,0.555555555555556,0.125
"Chr10","6788312","C","T",85,91,176,160,97,105,202,160,0.51980198019802,0.517045454545455,0.481481481481481,0.00275652565256523
"Chr10","6788507","A","T",62,68,130,143,74,74,148,143,0.5,0.523076923076923,0.489208633093525,-0.0230769230769231
"Chr10","6788525","G","A",44,63,107,160,71,56,127,160,0.440944881889764,0.588785046728972,0.491452991452991,-0.147840164839208
"Chr10","6788557","A","G",44,66,110,160,75,74,149,160,0.496644295302013,0.6,0.459459459459459,-0.103355704697987
"Chr10","6788704","T","G",68,72,140,138,90,64,154,138,0.415584415584416,0.514285714285714,0.537414965986395,-0.0987012987012986
"Chr10","6788828","G","C",56,59,115,144,73,66,139,144,0.474820143884892,0.51304347826087,0.507874015748031,-0.0382233343759775
"Chr10","6788885","A","G",47,60,107,160,62,66,128,160,0.515625,0.560747663551402,0.463829787234043,-0.0451226635514018
"Chr10","6788898","G","A",41,56,97,144,52,60,112,144,0.535714285714286,0.577319587628866,0.444976076555024,-0.0416053019145802
"Chr10","6788914","A","G",40,56,96,153,46,59,105,153,0.561904761904762,0.583333333333333,0.427860696517413,-0.0214285714285715
"Chr10","6789243","T","C",41,45,86,145,66,50,116,145,0.431034482758621,0.523255813953488,0.52970297029703,-0.0922213311948678
"Chr10","6789295","C","T",41,53,94,146,69,60,129,146,0.465116279069767,0.563829787234043,0.493273542600897,-0.0987135081642751
"Chr10","6789467","A","G",29,45,74,151,41,46,87,151,0.528735632183908,0.608108108108108,0.434782608695652,-0.0793724759242
"Chr10","6789504","C","A",20,49,69,141,41,41,82,141,0.5,0.710144927536232,0.403973509933775,-0.210144927536232
"Chr10","6790542","T","G",36,32,68,140,69,22,91,140,0.241758241758242,0.470588235294118,0.660377358490566,-0.228829993535876
"Chr10","6790555","G","C",39,35,74,142,72,29,101,142,0.287128712871287,0.472972972972973,0.634285714285714,-0.185844260101686
"Chr10","6790927","C","T",73,72,145,160,102,71,173,160,0.410404624277457,0.496551724137931,0.550314465408805,-0.0861470998604744
"Chr10","6790952","C","T",73,67,140,149,95,75,170,149,0.441176470588235,0.478571428571429,0.541935483870968,-0.0373949579831933
"Chr10","6791106","C","T",73,67,140,136,100,80,180,136,0.444444444444444,0.478571428571429,0.540625,-0.0341269841269842
"Chr10","6791115","G","A",78,67,145,160,101,81,182,160,0.445054945054945,0.462068965517241,0.547400611620795,-0.0170140204622963
"Chr10","6791169","A","G",92,65,157,144,114,82,196,144,0.418367346938776,0.414012738853503,0.58356940509915,0.00435460808527233
"Chr10","6791204","A","G",75,53,128,160,92,75,167,160,0.449101796407186,0.4140625,0.566101694915254,0.0350392964071856
"Chr10","6791259","G","A",61,46,107,142,72,52,124,142,0.419354838709677,0.429906542056075,0.575757575757576,-0.0105517033463973
"Chr10","6791402","T","C",85,89,174,138,109,79,188,138,0.420212765957447,0.511494252873563,0.535911602209945,-0.0912814869161164
"Chr10","6791431","T","C",87,73,160,160,97,78,175,160,0.445714285714286,0.45625,0.549253731343284,-0.0105357142857143
"Chr10","6791522","T","C",70,46,116,146,74,74,148,146,0.5,0.396551724137931,0.545454545454545,0.103448275862069
"Chr10","6791536","A","C",50,35,85,160,69,66,135,160,0.488888888888889,0.411764705882353,0.540909090909091,0.077124183006536
"Chr10","6791851","G","C",20,21,41,160,35,33,68,160,0.485294117647059,0.51219512195122,0.504587155963303,-0.0269010043041607
"Chr10","6791862","G","T",18,17,35,148,34,31,65,148,0.476923076923077,0.485714285714286,0.52,-0.00879120879120876
"Chr10","6791870","C","T",19,15,34,147,33,34,67,147,0.507462686567164,0.441176470588235,0.514851485148515,0.0662862159789289
"Chr10","6792757","G","C",58,53,111,144,96,65,161,144,0.403726708074534,0.477477477477477,0.566176470588235,-0.0737507694029433
"Chr10","6792818","A","C",57,57,114,160,89,90,179,160,0.502793296089385,0.5,0.498293515358362,0.0027932960893855
"Chr10","6793048","A","G",59,57,116,139,75,74,149,139,0.496644295302013,0.491379310344828,0.505660377358491,0.00526498495718586
"Chr10","6793077","G","A",56,56,112,160,71,68,139,160,0.489208633093525,0.5,0.50597609561753,-0.0107913669064748
"Chr10","6793086","G","A",54,61,115,160,73,70,143,160,0.48951048951049,0.530434782608696,0.492248062015504,-0.0409242930982062
"Chr10","6793106","G","A",65,58,123,145,81,74,155,145,0.47741935483871,0.471544715447154,0.525179856115108,0.00587463939155519
"Chr10","6793393","C","T",71,79,150,160,91,81,172,160,0.47093023255814,0.526666666666667,0.503105590062112,-0.0557364341085271
"Chr10","6793403","G","T",76,78,154,137,102,86,188,137,0.457446808510638,0.506493506493506,0.52046783625731,-0.0490466979828681
"Chr10","6793716","C","T",49,84,133,140,94,70,164,140,0.426829268292683,0.631578947368421,0.481481481481481,-0.204749679075738
"Chr10","6793831","C","T",53,88,141,160,77,65,142,160,0.457746478873239,0.624113475177305,0.459363957597173,-0.166366996304066
"Chr10","6794039","G","C",68,67,135,145,89,75,164,145,0.457317073170732,0.496296296296296,0.525083612040134,-0.0389792231255646
"Chr10","6794200","A","G",50,76,126,160,72,77,149,160,0.516778523489933,0.603174603174603,0.443636363636364,-0.0863960796846702
"Chr10","6794302","C","T",38,68,106,160,56,62,118,160,0.525423728813559,0.641509433962264,0.419642857142857,-0.116085705148705
"Chr10","6794439","C","T",35,58,93,160,61,52,113,160,0.460176991150442,0.623655913978495,0.466019417475728,-0.163478922828052
"Chr10","6794489","C","T",42,57,99,141,65,67,132,141,0.507575757575758,0.575757575757576,0.463203463203463,-0.0681818181818182
"Chr10","6794511","G","A",36,58,94,145,68,70,138,145,0.507246376811594,0.617021276595745,0.448275862068966,-0.10977489978415
"Chr10","6794714","C","T",37,38,75,140,49,49,98,140,0.5,0.506666666666667,0.497109826589595,-0.00666666666666671
"Chr10","6794721","C","T",38,40,78,160,49,51,100,160,0.51,0.512820512820513,0.48876404494382,-0.00282051282051277
"Chr10","6794844","C","A",27,43,70,148,47,45,92,148,0.489130434782609,0.614285714285714,0.45679012345679,-0.125155279503106
"Chr10","6794850","T","A",25,45,70,160,48,46,94,160,0.48936170212766,0.642857142857143,0.445121951219512,-0.153495440729483
"Chr10","6795015","G","A",32,39,71,160,36,25,61,160,0.409836065573771,0.549295774647887,0.515151515151515,-0.139459709074117
"Chr10","6795021","C","T",32,36,68,149,35,24,59,149,0.406779661016949,0.529411764705882,0.52755905511811,-0.122632103688933
"Chr10","6795156","A","G",30,32,62,160,27,36,63,160,0.571428571428571,0.516129032258065,0.456,0.0552995391705069
"Chr10","6795241","G","A",33,40,73,139,35,37,72,139,0.513888888888889,0.547945205479452,0.468965517241379,-0.0340563165905632
"Chr10","6795323","T","C",31,36,67,160,29,33,62,160,0.532258064516129,0.537313432835821,0.465116279069767,-0.00505536831969189
"Chr10","6795429","G","T",25,31,56,140,27,40,67,140,0.597014925373134,0.553571428571429,0.422764227642276,0.0434434968017057
"Chr10","6795494","A","G",19,25,44,144,25,32,57,144,0.56140350877193,0.568181818181818,0.435643564356436,-0.00677830940988844
"Chr10","6795612","C","T",28,51,79,139,31,45,76,139,0.592105263157895,0.645569620253165,0.380645161290323,-0.0534643570952699
"Chr10","6795686","A","G",31,35,66,160,30,42,72,160,0.583333333333333,0.53030303030303,0.442028985507246,0.0530303030303031
"Chr10","6795805","C","A",20,37,57,143,30,41,71,143,0.577464788732394,0.649122807017544,0.390625,-0.0716580182851495
"Chr10","6795858","A","T",22,31,53,160,33,39,72,160,0.541666666666667,0.584905660377358,0.44,-0.0432389937106918
"Chr10","6795868","C","T",18,18,36,143,29,36,65,143,0.553846153846154,0.5,0.465346534653465,0.0538461538461539
"Chr10","6795936","T","C",24,9,33,80,29,12,41,160,0.292682926829268,0.272727272727273,0.716216216216216,0.0199556541019956
"Chr10","6796073","T","G",20,20,40,160,36,18,54,160,0.333333333333333,0.5,0.595744680851064,-0.166666666666667
"Chr10","6796085","T","G",19,23,42,160,33,22,55,160,0.4,0.547619047619048,0.536082474226804,-0.147619047619048
"Chr10","6797940","A","G",41,31,72,145,54,49,103,145,0.475728155339806,0.430555555555556,0.542857142857143,0.0451725997842503
"Chr10","6798096","A","C",36,35,71,141,53,32,85,141,0.376470588235294,0.492957746478873,0.57051282051282,-0.116487158243579
"Chr10","6798291","C","A",53,42,95,160,87,72,159,160,0.452830188679245,0.442105263157895,0.551181102362205,0.0107249255213506
"Chr10","6798313","C","T",60,39,99,160,78,64,142,160,0.450704225352113,0.393939393939394,0.572614107883817,0.0567648314127188
"Chr10","6798592","T","A",41,60,101,144,73,56,129,144,0.434108527131783,0.594059405940594,0.495652173913044,-0.159950878808811
"Chr10","6799174","A","T",57,94,151,142,109,101,210,142,0.480952380952381,0.622516556291391,0.45983379501385,-0.14156417533901
"Chr10","6799231","C","G",66,94,160,149,96,91,187,149,0.486631016042781,0.5875,0.46685878962536,-0.100868983957219
"Chr10","6799379","T","C",52,107,159,160,76,69,145,160,0.475862068965517,0.672955974842767,0.421052631578947,-0.19709390587725
"Chr10","6799401","G","C",63,102,165,160,76,69,145,160,0.475862068965517,0.618181818181818,0.448387096774194,-0.142319749216301
"Chr10","6805041","T","A",54,81,135,148,78,76,154,148,0.493506493506494,0.6,0.456747404844291,-0.106493506493506
"Chr10","6805103","G","C",76,101,177,160,99,110,209,160,0.526315789473684,0.570621468926554,0.453367875647668,-0.0443056794528695
"Chr10","6805148","G","C",70,96,166,160,91,120,211,160,0.568720379146919,0.578313253012048,0.427055702917772,-0.00959287386512875
"Chr10","6805250","T","C",68,82,150,160,100,103,203,160,0.507389162561576,0.546666666666667,0.475920679886686,-0.0392775041050902
"Chr10","6805442","T","G",64,74,138,160,69,87,156,160,0.557692307692308,0.536231884057971,0.452380952380952,0.0214604236343366
"Chr10","6805450","G","A",64,73,137,151,67,90,157,151,0.573248407643312,0.532846715328467,0.445578231292517,0.0404016923148449
"Chr10","6805708","G","A",74,72,146,160,81,94,175,160,0.537142857142857,0.493150684931507,0.482866043613707,0.0439921722113503
"Chr10","6805875","C","G",64,59,123,160,65,63,128,160,0.4921875,0.479674796747967,0.51394422310757,0.0125127032520325
"Chr10","6805975","G","C",71,64,135,140,81,58,139,140,0.41726618705036,0.474074074074074,0.554744525547445,-0.0568078870237144
"Chr10","6805981","C","T",68,65,133,160,81,57,138,160,0.41304347826087,0.488721804511278,0.549815498154982,-0.0756783262504086
"Chr10","6806001","C","T",65,56,121,160,86,64,150,160,0.426666666666667,0.462809917355372,0.55719557195572,-0.0361432506887052
"Chr10","6806032","G","C",69,52,121,141,81,69,150,141,0.46,0.429752066115702,0.553505535055351,0.0302479338842975
"Chr10","6806113","G","C",60,58,118,140,88,81,169,140,0.479289940828402,0.491525423728814,0.515679442508711,-0.0122354829004112
"Chr10","6806689","A","G",68,60,128,143,94,83,177,143,0.468926553672316,0.46875,0.531147540983607,0.000176553672316393
"Chr10","6806758","A","C",75,67,142,160,89,79,168,160,0.470238095238095,0.471830985915493,0.529032258064516,-0.00159289067739771
"Chr10","6807186","G","A",94,94,188,160,84,64,148,160,0.432432432432432,0.5,0.529761904761905,-0.0675675675675675
"Chr10","6807201","T","C",94,86,180,160,93,67,160,160,0.41875,0.477777777777778,0.55,-0.0590277777777778
"Chr10","6807261","G","A",112,88,200,160,89,72,161,160,0.447204968944099,0.44,0.556786703601108,0.00720496894409939
"Chr10","6807500","G","A",70,61,131,160,73,50,123,160,0.40650406504065,0.465648854961832,0.562992125984252,-0.0591447899211817
"Chr10","6807507","A","G",74,65,139,139,74,53,127,139,0.417322834645669,0.467625899280576,0.556390977443609,-0.0503030646349062
"Chr10","6808873","A","C",45,52,97,160,64,48,112,160,0.428571428571429,0.536082474226804,0.521531100478469,-0.107511045655376
"Chr10","6809174","T","G",56,69,125,147,64,53,117,147,0.452991452991453,0.552,0.495867768595041,-0.0990085470085471
"Chr10","6809223","C","T",44,51,95,136,48,52,100,136,0.52,0.536842105263158,0.471794871794872,-0.0168421052631579
"Chr10","6809271","T","C",35,31,66,160,44,40,84,160,0.476190476190476,0.46969696969697,0.526666666666667,0.00649350649350644
"Chr10","6809323","C","T",22,41,63,141,28,41,69,141,0.594202898550725,0.650793650793651,0.378787878787879,-0.0565907522429262
"Chr10","6809348","T","C",24,47,71,139,30,44,74,139,0.594594594594595,0.661971830985915,0.372413793103448,-0.0673772363913209
"Chr10","6809586","C","T",15,23,38,160,46,27,73,160,0.36986301369863,0.605263157894737,0.54954954954955,-0.235400144196107
"Chr10","6809910","C","A",68,60,128,160,71,75,146,160,0.513698630136986,0.46875,0.507299270072993,0.0449486301369864
"Chr10","6810057","C","G",47,51,98,160,72,68,140,160,0.485714285714286,0.520408163265306,0.5,-0.0346938775510204
"Chr10","6810073","A","G",57,57,114,160,82,67,149,160,0.449664429530201,0.5,0.52851711026616,-0.0503355704697986
"Chr10","6810095","G","A",60,62,122,160,93,72,165,160,0.436363636363636,0.508196721311475,0.533101045296167,-0.0718330849478391
"Chr10","6810150","G","A",63,62,125,137,103,78,181,137,0.430939226519337,0.496,0.542483660130719,-0.065060773480663
"Chr10","6810161","G","A",66,65,131,160,101,81,182,160,0.445054945054945,0.49618320610687,0.533546325878594,-0.0511282610519252
"Chr10","6810175","T","C",63,59,122,136,93,79,172,136,0.459302325581395,0.483606557377049,0.530612244897959,-0.0243042317956538
"Chr10","6810187","G","A",73,59,132,160,100,82,182,160,0.450549450549451,0.446969696969697,0.550955414012739,0.0035797535797536
"Chr10","6810192","A","G",74,63,137,138,102,86,188,138,0.457446808510638,0.45985401459854,0.541538461538462,-0.00240720608790185
"Chr10","6810238","A","G",73,67,140,160,96,97,193,160,0.50259067357513,0.478571428571429,0.507507507507508,0.024019245003701
"Chr10","6810376","A","T",97,96,193,160,119,116,235,160,0.493617021276596,0.49740932642487,0.504672897196262,-0.00379230514827472
"Chr10","6810434","A","C",90,107,197,137,146,106,252,137,0.420634920634921,0.543147208121827,0.525612472160356,-0.122512287486907
"Chr10","6810523","G","A",92,108,200,160,145,111,256,160,0.43359375,0.54,0.519736842105263,-0.10640625
"Chr10","6810704","T","C",46,71,117,160,72,70,142,160,0.492957746478873,0.606837606837607,0.455598455598456,-0.113879860358734
"Chr10","6810710","T","C",47,68,115,160,66,70,136,160,0.514705882352941,0.591304347826087,0.450199203187251,-0.0765984654731459
"Chr10","6810956","C","T",56,80,136,141,84,83,167,141,0.497005988023952,0.588235294117647,0.462046204620462,-0.091229306093695
"Chr10","6811107","T","C",36,44,80,148,77,52,129,148,0.403100775193798,0.55,0.54066985645933,-0.146899224806202
"Chr10","6811129","G","T",35,37,72,140,80,55,135,140,0.407407407407407,0.513888888888889,0.555555555555556,-0.106481481481481
"Chr10","6811136","G","A",31,35,66,160,77,49,126,160,0.388888888888889,0.53030303030303,0.5625,-0.141414141414141
"Chr10","6811190","G","A",31,37,68,139,70,65,135,139,0.481481481481481,0.544117647058823,0.497536945812808,-0.062636165577342
"Chr10","6811227","A","G",27,22,49,160,47,54,101,160,0.534653465346535,0.448979591836735,0.493333333333333,0.0856738735098
"Chr10","6811541","A","G",54,73,127,160,86,71,157,160,0.452229299363057,0.574803149606299,0.492957746478873,-0.122573850243242
"Chr10","6812714","G","A",70,86,156,140,132,84,216,140,0.388888888888889,0.551282051282051,0.543010752688172,-0.162393162393162
"Chr10","6812724","G","A",67,80,147,136,127,81,208,136,0.389423076923077,0.54421768707483,0.546478873239437,-0.154794610151753
"Chr10","6812879","T","C",72,90,162,160,101,92,193,160,0.476683937823834,0.555555555555556,0.487323943661972,-0.0788716177317214
"Chr10","6812997","C","T",85,84,169,160,113,79,192,160,0.411458333333333,0.497041420118343,0.548476454293629,-0.0855830867850099
"Chr10","6813048","G","A",71,76,147,160,105,69,174,160,0.396551724137931,0.517006802721088,0.548286604361371,-0.120455078583157
"Chr10","6814077","A","G",44,57,101,160,67,59,126,160,0.468253968253968,0.564356435643564,0.488986784140969,-0.096102467389596
"Chr10","6814164","A","G",38,52,90,160,49,56,105,160,0.533333333333333,0.577777777777778,0.446153846153846,-0.0444444444444444
"Chr10","6814333","G","A",32,30,62,143,47,32,79,143,0.40506329113924,0.483870967741935,0.560283687943262,-0.078807676602695
"Chr10","6814383","T","C",22,23,45,149,37,22,59,149,0.372881355932203,0.511111111111111,0.567307692307692,-0.138229755178908
"Chr10","6814424","G","A",30,25,55,149,27,21,48,149,0.4375,0.454545454545455,0.553398058252427,-0.0170454545454545
"Chr10","6814756","T","C",35,25,60,142,29,26,55,142,0.472727272727273,0.416666666666667,0.556521739130435,0.056060606060606
"Chr10","6814793","G","T",30,21,51,160,27,31,58,160,0.53448275862069,0.411764705882353,0.522935779816514,0.122718052738337
"Chr10","6815289","A","T",34,30,64,140,67,48,115,140,0.417391304347826,0.46875,0.564245810055866,-0.0513586956521739
"Chr10","6816457","A","G",28,65,93,160,70,51,121,160,0.421487603305785,0.698924731182796,0.457943925233645,-0.277437127877011
"Chr10","6817834","T","C",19,26,45,160,22,14,36,160,0.388888888888889,0.577777777777778,0.506172839506173,-0.188888888888889
"Chr10","6818881","C","T",17,26,43,160,35,28,63,160,0.444444444444444,0.604651162790698,0.490566037735849,-0.160206718346253
"Chr10","6819042","G","A",31,45,76,160,44,40,84,160,0.476190476190476,0.592105263157895,0.46875,-0.115914786967419
"Chr10","6819349","G","A",21,25,46,144,21,33,54,144,0.611111111111111,0.543478260869565,0.42,0.067632850241546
"Chr10","6819538","T","A",66,52,118,160,75,71,146,160,0.486301369863014,0.440677966101695,0.534090909090909,0.0456234037613188
"Chr10","6820165","G","A",63,64,127,160,87,77,164,160,0.469512195121951,0.503937007874016,0.515463917525773,-0.0344248127520645
"Chr10","6820923","G","A",42,39,81,139,49,33,82,139,0.402439024390244,0.481481481481481,0.558282208588957,-0.0790424570912375
"Chr10","6822861","T","C",49,67,116,160,62,48,110,160,0.436363636363636,0.577586206896552,0.491150442477876,-0.141222570532915
"Chr10","6823672","T","C",68,92,160,160,92,93,185,160,0.502702702702703,0.575,0.463768115942029,-0.0722972972972973
"Chr10","6826625","A","G",82,122,204,160,128,120,248,160,0.483870967741935,0.598039215686274,0.464601769911504,-0.114168247944339
"Chr10","6826729","C","G",80,134,214,137,148,140,288,137,0.486111111111111,0.626168224299065,0.454183266932271,-0.140057113187954
"Chr10","6828427","A","G",55,77,132,160,85,78,163,160,0.478527607361963,0.583333333333333,0.474576271186441,-0.10480572597137
"Chr10","6829423","A","C",33,36,69,160,43,34,77,160,0.441558441558442,0.521739130434783,0.520547945205479,-0.0801806888763411
"Chr10","6830497","T","C",82,89,171,160,112,99,211,160,0.469194312796209,0.52046783625731,0.507853403141361,-0.0512735234611014
"Chr10","6831226","T","C",55,47,102,141,58,62,120,141,0.516666666666667,0.46078431372549,0.509009009009009,0.0558823529411765
"Chr10","6831276","C","T",53,58,111,139,55,63,118,139,0.533898305084746,0.522522522522523,0.471615720524017,0.0113757825622233
"Chr10","6831925","C","T",60,48,108,140,69,56,125,140,0.448,0.444444444444444,0.553648068669528,0.00355555555555559
"Chr10","6831932","G","A",62,45,107,160,67,54,121,160,0.446280991735537,0.420560747663551,0.565789473684211,0.0257202440719858
"Chr10","6831953","C","T",56,50,106,160,69,54,123,160,0.439024390243902,0.471698113207547,0.54585152838428,-0.0326737229636447
"Chr10","6831958","T","C",54,47,101,160,68,60,128,160,0.46875,0.465346534653465,0.532751091703057,0.00340346534653463
"Chr10","6831994","C","T",57,49,106,136,73,64,137,136,0.467153284671533,0.462264150943396,0.534979423868313,0.0048891337281366
"Chr10","6832011","C","T",54,51,105,160,73,65,138,160,0.471014492753623,0.485714285714286,0.522633744855967,-0.0146997929606625
"Chr10","6832664","T","C",61,65,126,136,82,74,156,136,0.474358974358974,0.515873015873016,0.50709219858156,-0.0415140415140416
"Chr10","6832802","T","C",50,58,108,140,66,50,116,140,0.431034482758621,0.537037037037037,0.517857142857143,-0.106002554278416
"Chr10","6832999","C","A",50,59,109,160,77,87,164,160,0.530487804878049,0.541284403669725,0.465201465201465,-0.0107965987916759
"Chr10","6833251","T","C",54,58,112,140,72,73,145,140,0.503448275862069,0.517857142857143,0.490272373540856,-0.0144088669950739
"Chr10","6833270","A","C",51,58,109,160,73,71,144,160,0.493055555555556,0.532110091743119,0.490118577075099,-0.0390545361875637
"Chr10","6833307","A","G",46,53,99,160,61,61,122,160,0.5,0.535353535353535,0.484162895927602,-0.0353535353535354
"Chr10","6833375","G","A",34,44,78,160,46,60,106,160,0.566037735849057,0.564102564102564,0.434782608695652,0.00193517174649249
"Chr10","6833492","G","A",15,25,40,160,41,36,77,160,0.467532467532468,0.625,0.478632478632479,-0.157467532467532
"Chr10","6833590","C","T",30,38,68,160,37,42,79,160,0.531645569620253,0.558823529411765,0.45578231292517,-0.0271779597915116
"Chr10","6834277","A","T",18,35,53,160,34,33,67,160,0.492537313432836,0.660377358490566,0.433333333333333,-0.16784004505773
"Chr10","6835171","A","G",18,35,53,144,29,33,62,144,0.532258064516129,0.660377358490566,0.408695652173913,-0.128119293974437
"Chr10","6835302","A","G",13,21,34,160,20,27,47,160,0.574468085106383,0.617647058823529,0.407407407407407,-0.0431789737171464
"Chr10","6835348","T","C",12,16,28,143,24,20,44,143,0.454545454545455,0.571428571428571,0.5,-0.116883116883117
"Chr10","6835407","T","C",15,9,24,160,28,24,52,160,0.461538461538462,0.375,0.565789473684211,0.0865384615384616
"Chr10","6835416","C","T",14,9,23,142,27,24,51,142,0.470588235294118,0.391304347826087,0.554054054054054,0.0792838874680307
"Chr10","6836471","C","T",36,30,66,160,57,47,104,160,0.451923076923077,0.454545454545455,0.547058823529412,-0.0026223776223776
"Chr10","6836812","C","T",21,14,35,142,43,22,65,142,0.338461538461538,0.4,0.64,-0.0615384615384615
"Chr10","6836927","T","C",22,13,35,160,29,26,55,160,0.472727272727273,0.371428571428571,0.566666666666667,0.101298701298701
"Chr10","6837141","A","T",11,7,18,141,7,7,14,141,0.5,0.388888888888889,0.5625,0.111111111111111
"Chr10","6837796","T","G",48,40,88,160,58,41,99,160,0.414141414141414,0.454545454545455,0.566844919786096,-0.0404040404040404
"Chr10","6837810","T","G",48,45,93,160,60,42,102,160,0.411764705882353,0.483870967741935,0.553846153846154,-0.0721062618595826
"Chr10","6837941","T","C",48,65,113,160,86,61,147,160,0.414965986394558,0.575221238938053,0.515384615384615,-0.160255252543495
"Chr10","6837946","C","T",49,61,110,137,87,59,146,137,0.404109589041096,0.554545454545455,0.53125,-0.150435865504359
"Chr10","6837964","A","G",50,55,105,160,91,62,153,160,0.405228758169935,0.523809523809524,0.546511627906977,-0.118580765639589
"Chr10","6837995","A","G",55,55,110,160,102,61,163,160,0.374233128834356,0.5,0.575091575091575,-0.125766871165644
"Chr10","6838058","G","T",39,48,87,143,71,48,119,143,0.403361344537815,0.551724137931034,0.533980582524272,-0.148362793393219
"Chr10","6838119","T","G",59,59,118,145,81,56,137,145,0.408759124087591,0.5,0.549019607843137,-0.0912408759124088
"Chr10","6838962","G","A",80,77,157,160,99,77,176,160,0.4375,0.490445859872611,0.537537537537538,-0.0529458598726115
"Chr10","6839360","T","A",85,91,176,160,109,98,207,160,0.473429951690821,0.517045454545455,0.506527415143603,-0.0436155028546333
"Chr10","6840573","A","C",11,23,34,160,21,20,41,160,0.48780487804878,0.676470588235294,0.426666666666667,-0.188665710186514
"Chr10","6841218","C","T",8,12,20,154,17,12,29,154,0.413793103448276,0.6,0.510204081632653,-0.186206896551724
"Chr10","6841260","T","C",7,18,25,138,33,10,43,145,0.232558139534884,0.72,0.588235294117647,-0.487441860465116
"Chr10","6841362","C","T",20,22,42,145,37,27,64,145,0.421875,0.523809523809524,0.537735849056604,-0.101934523809524
"Chr10","6841495","G","A",33,46,79,160,56,56,112,160,0.5,0.582278481012658,0.465968586387435,-0.0822784810126582
"Chr10","6841547","T","C",35,42,77,160,68,48,116,160,0.413793103448276,0.545454545454545,0.533678756476684,-0.13166144200627
"Chr10","6841559","T","C",37,42,79,160,69,48,117,160,0.41025641025641,0.531645569620253,0.540816326530612,-0.121389159363843
"Chr10","6841619","G","A",39,44,83,148,79,51,130,148,0.392307692307692,0.530120481927711,0.553990610328638,-0.137812789620019
"Chr10","6841711","G","A",33,45,78,147,72,73,145,147,0.503448275862069,0.576923076923077,0.47085201793722,-0.0734748010610079
"Chr10","6841793","A","T",46,46,92,160,79,72,151,160,0.47682119205298,0.5,0.51440329218107,-0.0231788079470199
"Chr10","6841822","A","C",46,35,81,160,74,55,129,160,0.426356589147287,0.432098765432099,0.571428571428571,-0.00574217628481194
"Chr10","6841916","C","A",60,53,113,139,71,64,135,139,0.474074074074074,0.469026548672566,0.528225806451613,0.00504752540150771
"Chr10","6841933","G","A",62,54,116,160,65,68,133,160,0.511278195488722,0.46551724137931,0.51004016064257,0.0457609541094114
"Chr10","6841973","C","T",58,57,115,150,65,66,131,150,0.50381679389313,0.495652173913044,0.5,0.00816461998008622
"Chr10","6842090","C","A",34,42,76,160,68,60,128,160,0.46875,0.552631578947368,0.5,-0.0838815789473685
"Chr10","6842246","T","G",56,48,104,138,93,88,181,138,0.486187845303867,0.461538461538462,0.52280701754386,0.0246493837654058
"Chr10","6842279","G","A",53,44,97,160,87,82,169,160,0.485207100591716,0.45360824742268,0.526315789473684,0.0315988531690355
"Chr10","6843146","T","C",18,11,29,143,26,8,34,135,0.235294117647059,0.379310344827586,0.698412698412698,-0.144016227180527
"Chr10","6843290","C","T",39,26,65,160,26,29,55,160,0.527272727272727,0.4,0.541666666666667,0.127272727272727
"Chr10","6843393","C","T",37,39,76,160,40,34,74,160,0.459459459459459,0.513157894736842,0.513333333333333,-0.0536984352773827
"Chr10","6843738","C","T",63,72,135,160,101,73,174,160,0.419540229885057,0.533333333333333,0.530744336569579,-0.113793103448276
"Chr10","6843999","G","T",65,68,133,141,91,66,157,141,0.420382165605096,0.511278195488722,0.537931034482759,-0.0908960298836262
"Chr10","6844680","T","C",62,80,142,160,71,77,148,160,0.52027027027027,0.563380281690141,0.458620689655172,-0.0431100114198706
"Chr10","6845437","C","G",45,47,92,147,67,61,128,147,0.4765625,0.510869565217391,0.509090909090909,-0.0343070652173914
"Chr10","6845679","G","A",59,58,117,160,63,63,126,160,0.5,0.495726495726496,0.502057613168724,0.00427350427350426
"Chr10","6845853","C","T",39,41,80,146,39,37,76,146,0.486842105263158,0.5125,0.5,-0.025657894736842
"Chr10","6845881","A","G",38,43,81,147,41,41,82,147,0.5,0.530864197530864,0.484662576687117,-0.0308641975308642
"Chr10","6846363","A","G",25,30,55,141,33,42,75,141,0.56,0.545454545454545,0.446153846153846,0.0145454545454546
"Chr10","6846407","T","G",23,24,47,160,34,32,66,160,0.484848484848485,0.51063829787234,0.504424778761062,-0.0257898130238555
"Chr10","6846477","A","G",20,18,38,147,39,22,61,147,0.360655737704918,0.473684210526316,0.595959595959596,-0.113028472821398
"Chr10","6847763","G","A",20,17,37,160,28,31,59,160,0.525423728813559,0.459459459459459,0.5,0.0659642693540999
"Chr10","6847830","C","T",15,14,29,160,30,21,51,160,0.411764705882353,0.482758620689655,0.5625,-0.0709939148073023
"Chr10","6849292","C","T",33,44,77,160,38,43,81,160,0.530864197530864,0.571428571428571,0.449367088607595,-0.0405643738977072
"Chr10","6849855","C","G",48,35,83,141,50,45,95,141,0.473684210526316,0.421686746987952,0.550561797752809,0.0519974635383639
"Chr10","6849930","G","A",72,38,110,140,89,45,134,140,0.335820895522388,0.345454545454545,0.659836065573771,-0.00963364993215737
"Chr10","6849961","T","A",82,63,145,160,115,69,184,160,0.375,0.43448275862069,0.598784194528875,-0.0594827586206896
"Chr10","6849990","G","T",80,73,153,138,119,89,208,138,0.427884615384615,0.477124183006536,0.551246537396122,-0.0492395676219206
"Chr10","6850025","A","G",81,85,166,138,123,77,200,138,0.385,0.512048192771084,0.557377049180328,-0.127048192771084
"Chr10","7253689","C","G",68,64,132,160,71,99,170,160,0.582352941176471,0.484848484848485,0.460264900662252,0.0975044563279858
"Chr10","7944990","G","T",40,60,100,139,64,66,130,139,0.507692307692308,0.6,0.452173913043478,-0.0923076923076923
"Chr10","8417971","G","A",63,101,164,160,108,84,192,160,0.4375,0.615853658536585,0.480337078651685,-0.178353658536585
"Chr10","9245246","C","T",36,54,90,152,65,54,119,152,0.453781512605042,0.6,0.483253588516746,-0.146218487394958
"Chr10","9272116","G","A",30,32,62,142,45,76,121,142,0.628099173553719,0.516129032258065,0.409836065573771,0.111970141295655
"Chr10","9303122","A","T",34,39,73,139,48,41,89,139,0.460674157303371,0.534246575342466,0.506172839506173,-0.073572418039095
"Chr10","9306793","T","A",29,11,40,143,19,33,52,143,0.634615384615385,0.275,0.521739130434783,0.359615384615385
"Chr10","9336524","A","G",43,22,65,146,18,37,55,146,0.672727272727273,0.338461538461538,0.508333333333333,0.334265734265734
"Chr10","9336851","T","C",47,30,77,160,34,57,91,160,0.626373626373626,0.38961038961039,0.482142857142857,0.236763236763237
"Chr10","9337305","G","T",50,35,85,142,46,44,90,142,0.488888888888889,0.411764705882353,0.548571428571429,0.077124183006536
"Chr10","9337545","G","C",54,29,83,160,48,40,88,160,0.454545454545455,0.349397590361446,0.596491228070175,0.105147864184009
"Chr10","9339002","A","G",25,19,44,160,39,17,56,160,0.303571428571429,0.431818181818182,0.64,-0.128246753246753
"Chr10","9339273","G","A",37,43,80,140,68,39,107,140,0.364485981308411,0.5375,0.561497326203209,-0.173014018691589
"Chr10","9340535","T","C",56,83,139,160,100,79,179,160,0.441340782122905,0.597122302158273,0.490566037735849,-0.155781520035368
"Chr10","9340562","A","T",60,86,146,160,102,79,181,160,0.43646408839779,0.589041095890411,0.495412844036697,-0.152577007492621
"Chr10","9341636","G","A",78,67,145,136,92,68,160,136,0.425,0.462068965517241,0.557377049180328,-0.0370689655172414
"Chr10","9341673","C","G",74,75,149,137,89,75,164,137,0.457317073170732,0.503355704697987,0.520766773162939,-0.0460386315272549
"Chr10","9341794","A","C",57,79,136,144,85,76,161,144,0.472049689440994,0.580882352941177,0.478114478114478,-0.108832663500183
"Chr10","9341852","C","T",63,80,143,144,97,69,166,144,0.41566265060241,0.559440559440559,0.517799352750809,-0.14377790883815
"Chr10","9341871","A","G",69,75,144,136,95,66,161,136,0.409937888198758,0.520833333333333,0.537704918032787,-0.110895445134576
"Chr10","9341892","C","A",64,75,139,160,94,62,156,160,0.397435897435897,0.539568345323741,0.535593220338983,-0.142132447887844
"Chr10","9342246","C","A",43,49,92,160,60,56,116,160,0.482758620689655,0.532608695652174,0.495192307692308,-0.0498500749625188
"Chr10","9342435","T","C",28,34,62,160,54,51,105,160,0.485714285714286,0.548387096774194,0.491017964071856,-0.0626728110599078
"Chr10","9342567","T","C",24,34,58,160,42,35,77,160,0.454545454545455,0.586206896551724,0.488888888888889,-0.13166144200627
"Chr10","9342602","C","T",20,21,41,160,24,27,51,160,0.529411764705882,0.51219512195122,0.478260869565217,0.0172166427546628
"Chr10","9342613","G","T",20,19,39,148,28,23,51,148,0.450980392156863,0.487179487179487,0.533333333333333,-0.0361990950226244
"Chr10","9342887","G","C",10,13,23,160,23,21,44,160,0.477272727272727,0.565217391304348,0.492537313432836,-0.0879446640316205
"Chr10","9343257","C","G",38,44,82,141,47,36,83,141,0.433734939759036,0.536585365853659,0.515151515151515,-0.102850426094622
"Chr10","9343395","T","C",39,28,67,160,40,54,94,160,0.574468085106383,0.417910447761194,0.490683229813665,0.156557637345189
"Chr10","9343409","T","C",33,36,69,160,37,51,88,160,0.579545454545455,0.521739130434783,0.445859872611465,0.057806324110672
"Chr10","9343936","G","T",50,41,91,146,46,42,88,146,0.477272727272727,0.450549450549451,0.536312849162011,0.0267232767232767
"Chr10","9344402","A","G",45,44,89,160,79,34,113,160,0.300884955752212,0.49438202247191,0.613861386138614,-0.193497066719698
"Chr10","9344842","A","G",42,35,77,141,70,35,105,141,0.333333333333333,0.454545454545455,0.615384615384615,-0.121212121212121
"Chr10","9345076","A","G",44,25,69,160,54,27,81,160,0.333333333333333,0.36231884057971,0.653333333333333,-0.0289855072463768
"Chr10","9345103","G","T",38,28,66,145,48,26,74,145,0.351351351351351,0.424242424242424,0.614285714285714,-0.0728910728910729
"Chr10","9345557","G","A",43,52,95,160,46,53,99,160,0.535353535353535,0.547368421052632,0.458762886597938,-0.0120148856990963
"Chr10","9345706","T","C",33,45,78,160,44,42,86,160,0.488372093023256,0.576923076923077,0.469512195121951,-0.0885509838998211
"Chr10","9345802","G","A",39,54,93,158,53,52,105,158,0.495238095238095,0.580645161290323,0.464646464646465,-0.0854070660522274
"Chr10","9346112","T","C",41,39,80,142,39,66,105,142,0.628571428571429,0.4875,0.432432432432432,0.141071428571429
"Chr10","9346132","G","A",47,41,88,148,39,72,111,148,0.648648648648649,0.465909090909091,0.4321608040201,0.182739557739558
"Chr10","9346951","G","A",22,28,50,160,35,27,62,160,0.435483870967742,0.56,0.508928571428571,-0.124516129032258
"Chr10","9347280","A","G",45,44,89,160,74,55,129,160,0.426356589147287,0.49438202247191,0.545871559633027,-0.0680254333246233
"Chr10","9347455","G","C",48,70,118,160,64,61,125,160,0.488,0.593220338983051,0.460905349794239,-0.105220338983051
"Chr10","9347680","C","A",55,55,110,140,80,63,143,140,0.440559440559441,0.5,0.533596837944664,-0.0594405594405594
"Chr10","9347691","T","C",51,52,103,160,76,63,139,160,0.453237410071942,0.504854368932039,0.524793388429752,-0.0516169588600964
"Chr10","9347735","A","G",52,62,114,139,78,72,150,139,0.48,0.543859649122807,0.492424242424242,-0.0638596491228071
"Chr10","9349245","T","G",38,33,71,140,38,25,63,140,0.396825396825397,0.464788732394366,0.567164179104478,-0.0679633355689694
"Chr10","9349731","C","G",44,50,94,160,63,30,93,160,0.32258064516129,0.531914893617021,0.572192513368984,-0.209334248455731
"Chr10","9349863","C","T",31,41,72,160,44,37,81,160,0.45679012345679,0.569444444444444,0.490196078431373,-0.112654320987654
"Chr10","9349881","T","C",32,48,80,150,49,46,95,150,0.484210526315789,0.6,0.462857142857143,-0.11578947368421
"Chr10","9349961","A","G",44,40,84,160,73,55,128,160,0.4296875,0.476190476190476,0.55188679245283,-0.0465029761904762
"Chr10","9350014","A","G",58,48,106,160,87,59,146,160,0.404109589041096,0.452830188679245,0.575396825396825,-0.0487205996381494
"Chr10","9350020","C","T",57,45,102,139,86,60,146,139,0.410958904109589,0.441176470588235,0.576612903225806,-0.0302175664786463
"Chr10","9350165","T","C",50,59,109,160,68,57,125,160,0.456,0.541284403669725,0.504273504273504,-0.0852844036697247
"Chr10","9350175","T","G",56,63,119,141,75,56,131,141,0.427480916030534,0.529411764705882,0.524,-0.101930848675348
"Chr10","9350201","C","G",49,59,108,160,65,55,120,160,0.458333333333333,0.546296296296296,0.5,-0.087962962962963
"Chr10","9350215","A","C",40,60,100,139,66,48,114,139,0.421052631578947,0.6,0.495327102803738,-0.178947368421053
"Chr10","9350956","G","A",85,87,172,160,98,94,192,160,0.489583333333333,0.505813953488372,0.502747252747253,-0.0162306201550388
"Chr10","9351170","G","A",41,35,76,146,45,43,88,146,0.488636363636364,0.460526315789474,0.524390243902439,0.02811004784689
"Chr10","9351176","G","A",40,34,74,160,44,42,86,160,0.488372093023256,0.459459459459459,0.525,0.0289126335637963
"Chr10","9351181","C","T",41,36,77,160,46,40,86,160,0.465116279069767,0.467532467532468,0.533742331288344,-0.00241618846270009
"Chr10","9351285","C","G",54,62,116,146,81,70,151,146,0.463576158940397,0.53448275862069,0.50561797752809,-0.0709065996802923
"Chr10","9351305","A","G",73,62,135,160,84,69,153,160,0.450980392156863,0.459259259259259,0.545138888888889,-0.0082788671023965
"Chr10","9351480","C","A",48,47,95,160,72,57,129,160,0.441860465116279,0.494736842105263,0.535714285714286,-0.0528763769889841
"Chr10","9351508","G","C",46,33,79,160,50,42,92,160,0.456521739130435,0.417721518987342,0.56140350877193,0.038800220143093
"Chr10","9351958","A","G",17,12,29,144,28,20,48,144,0.416666666666667,0.413793103448276,0.584415584415584,0.00287356321839083
"Chr10","9357403","G","C",14,17,31,142,43,32,75,142,0.426666666666667,0.548387096774194,0.537735849056604,-0.121720430107527
"Chr10","9357535","G","T",37,51,88,160,46,47,93,160,0.505376344086022,0.579545454545455,0.458563535911602,-0.0741691104594331
"Chr10","9357856","A","C",46,58,104,140,78,48,126,140,0.380952380952381,0.557692307692308,0.539130434782609,-0.176739926739927
"Chr10","9357953","T","C",46,58,104,160,65,42,107,160,0.392523364485981,0.557692307692308,0.5260663507109,-0.165168943206326
"Chr10","9358077","A","C",32,44,76,146,49,43,92,146,0.467391304347826,0.578947368421053,0.482142857142857,-0.111556064073227
"Chr10","9358194","C","G",36,38,74,143,74,53,127,143,0.417322834645669,0.513513513513513,0.54726368159204,-0.0961906788678442
"Chr10","9358285","G","T",53,43,96,148,77,59,136,148,0.433823529411765,0.447916666666667,0.560344827586207,-0.014093137254902
"Chr10","9358618","C","A",52,66,118,145,76,68,144,145,0.472222222222222,0.559322033898305,0.488549618320611,-0.0870998116760828
"Chr10","9358747","C","G",51,55,106,160,73,77,150,160,0.513333333333333,0.518867924528302,0.484375,-0.00553459119496857
"Chr10","9358761","G","A",54,67,121,150,77,79,156,150,0.506410256410256,0.553719008264463,0.472924187725632,-0.0473087518542065
"Chr10","9358803","C","A",60,72,132,140,92,74,166,140,0.44578313253012,0.545454545454545,0.51006711409396,-0.0996714129244249
"Chr10","9358840","A","G",64,75,139,160,97,76,173,160,0.439306358381503,0.539568345323741,0.516025641025641,-0.100261986942238
"Chr10","9358872","C","T",77,67,144,146,93,65,158,146,0.411392405063291,0.465277777777778,0.562913907284768,-0.0538853727144866
"Chr10","9358924","C","T",82,64,146,160,102,75,177,160,0.423728813559322,0.438356164383562,0.569659442724458,-0.0146273508242396
"Chr10","9358935","T","C",87,68,155,137,119,75,194,137,0.38659793814433,0.438709677419355,0.590257879656161,-0.0521117392750249
"Chr10","9358956","A","G",90,56,146,136,109,69,178,136,0.387640449438202,0.383561643835616,0.614197530864197,0.00407880560258583
"Chr10","9358964","C","T",90,58,148,160,101,73,174,160,0.419540229885057,0.391891891891892,0.593167701863354,0.0276483379931656
"Chr10","9358990","C","A",96,63,159,140,104,76,180,140,0.422222222222222,0.39622641509434,0.589970501474926,0.0259958071278826
"Chr10","9359195","T","G",62,62,124,146,93,54,147,146,0.36734693877551,0.5,0.571955719557196,-0.13265306122449
"Chr10","9359262","G","T",55,68,123,138,97,57,154,138,0.37012987012987,0.552845528455285,0.548736462093863,-0.182715658325414
"Chr10","9360000","A","G",103,64,167,160,89,63,152,160,0.414473684210526,0.383233532934132,0.601880877742947,0.0312401512763946
"Chr10","9360123","T","A",103,78,181,160,104,86,190,160,0.452631578947368,0.430939226519337,0.557951482479784,0.0216923524280314
"Chr10","9361088","G","C",56,58,114,140,95,72,167,140,0.431137724550898,0.508771929824561,0.537366548042705,-0.0776342052736632
"Chr10","9361106","G","T",64,68,132,160,81,84,165,160,0.509090909090909,0.515151515151515,0.488215488215488,-0.0060606060606061
"Chr10","9361383","T","C",49,74,123,145,82,73,155,145,0.470967741935484,0.601626016260163,0.471223021582734,-0.130658274324679
"Chr10","9361578","G","A",42,56,98,138,46,56,102,138,0.549019607843137,0.571428571428571,0.44,-0.0224089635854341
"Chr10","9362002","C","G",13,46,59,141,18,30,48,141,0.625,0.779661016949153,0.289719626168224,-0.154661016949153
"Chr10","9362579","G","C",32,33,65,160,36,28,64,160,0.4375,0.507692307692308,0.527131782945736,-0.0701923076923077
"Chr10","9363200","C","A",57,63,120,141,77,56,133,141,0.421052631578947,0.525,0.529644268774704,-0.103947368421053
"Chr10","9363532","C","T",60,64,124,160,80,60,140,160,0.428571428571429,0.516129032258065,0.53030303030303,-0.087557603686636
"Chr10","9364107","G","T",53,49,102,0,80,65,145,129,0.448275862068966,0.480392156862745,0.538461538461538,-0.0321162947937796
"Chr10","9366811","G","T",63,97,160,137,82,99,181,137,0.546961325966851,0.60625,0.425219941348974,-0.0592886740331491
"Chr10","9367507","C","T",85,62,147,136,136,75,211,136,0.355450236966825,0.421768707482993,0.61731843575419,-0.0663184705161686
"Chr10","9367598","G","C",79,58,137,160,112,72,184,160,0.391304347826087,0.423357664233577,0.595015576323987,-0.0320533164074897
"Chr10","9367893","C","G",83,78,161,138,121,90,211,138,0.42654028436019,0.484472049689441,0.548387096774194,-0.0579317653292514
"Chr10","9368689","G","A",84,67,151,137,121,62,183,137,0.33879781420765,0.443708609271523,0.61377245508982,-0.104910795063873
"Chr10","9369605","C","T",39,45,84,139,74,65,139,139,0.467625899280576,0.535714285714286,0.506726457399103,-0.0680883864337102
"Chr10","9370296","C","G",45,57,102,160,81,70,151,160,0.463576158940397,0.558823529411765,0.49802371541502,-0.0952473704713674
"Chr10","9370454","A","G",55,53,108,145,58,75,133,145,0.56390977443609,0.490740740740741,0.468879668049793,0.0731690336953495
"Chr10","9370700","A","G",59,67,126,160,73,69,142,160,0.485915492957746,0.531746031746032,0.492537313432836,-0.0458305387882852
"Chr10","9370752","C","G",70,68,138,160,80,76,156,160,0.487179487179487,0.492753623188406,0.510204081632653,-0.00557413600891865
"Chr10","9370813","A","C",76,70,146,160,97,89,186,160,0.478494623655914,0.479452054794521,0.521084337349398,-0.000957431138606524
"Chr10","9370840","A","C",77,61,138,138,86,82,168,138,0.488095238095238,0.442028985507246,0.532679738562091,0.0460662525879917
"Chr10","9370855","A","T",76,63,139,144,82,80,162,144,0.493827160493827,0.453237410071942,0.524916943521595,0.0405897504218847
"Chr10","9370890","A","G",69,52,121,160,80,72,152,160,0.473684210526316,0.429752066115702,0.545787545787546,0.0439321444106133
"Chr10","9370949","T","C",73,83,156,136,95,88,183,136,0.480874316939891,0.532051282051282,0.495575221238938,-0.0511769651113914
"Chr10","9371127","T","A",55,69,124,160,60,54,114,160,0.473684210526316,0.556451612903226,0.483193277310924,-0.08276740237691
"Chr10","9371178","G","C",69,85,154,140,89,73,162,140,0.450617283950617,0.551948051948052,0.5,-0.101330767997435
"Chr10","9371238","T","C",54,66,120,146,81,71,152,146,0.467105263157895,0.55,0.496323529411765,-0.0828947368421053
"Chr10","9371274","A","G",63,58,121,150,90,72,162,150,0.444444444444444,0.479338842975207,0.540636042402827,-0.0348943985307622
"Chr10","9371344","G","A",63,48,111,160,88,69,157,160,0.439490445859873,0.432432432432432,0.563432835820896,0.00705801342744017
"Chr10","9371456","A","G",60,64,124,160,96,67,163,160,0.411042944785276,0.516129032258065,0.543554006968641,-0.105086087472788
"Chr10","9371510","C","A",59,69,128,155,81,66,147,155,0.448979591836735,0.5390625,0.509090909090909,-0.0900829081632653
"Chr10","9371611","C","A",48,56,104,160,51,72,123,160,0.585365853658537,0.538461538461538,0.436123348017621,0.0469043151969981
"Chr10","9371641","G","A",41,48,89,141,50,72,122,141,0.590163934426229,0.539325842696629,0.431279620853081,0.0508380917296003
"Chr10","9371659","A","G",41,45,86,160,52,68,120,160,0.566666666666667,0.523255813953488,0.451456310679612,0.0434108527131782
"Chr10","9371834","G","A",59,52,111,160,58,48,106,160,0.452830188679245,0.468468468468468,0.539170506912442,-0.0156382797892232
"Chr10","9371846","A","T",60,54,114,139,63,55,118,139,0.466101694915254,0.473684210526316,0.530172413793103,-0.00758251561106155
"Chr10","9371891","C","G",62,48,110,160,74,55,129,160,0.426356589147287,0.436363636363636,0.569037656903766,-0.0100070472163495
"Chr10","9372099","G","A",63,72,135,150,79,81,160,150,0.50625,0.533333333333333,0.48135593220339,-0.0270833333333333
"Chr10","9372128","A","G",65,68,133,160,66,74,140,160,0.528571428571429,0.511278195488722,0.47985347985348,0.0172932330827068
"Chr10","9372208","T","C",55,59,114,141,83,58,141,141,0.411347517730496,0.517543859649123,0.541176470588235,-0.106196341918626
"Chr10","9372235","G","A",58,65,123,160,83,53,136,160,0.389705882352941,0.528455284552846,0.544401544401544,-0.138749402199904
"Chr10","9372441","A","G",41,47,88,148,74,56,130,148,0.430769230769231,0.534090909090909,0.527522935779816,-0.103321678321678
"Chr10","9372496","A","G",47,47,94,141,69,54,123,141,0.439024390243902,0.5,0.534562211981567,-0.0609756097560976
"Chr10","9372502","T","C",47,45,92,160,69,51,120,160,0.425,0.489130434782609,0.547169811320755,-0.0641304347826087
"Chr10","9372557","G","A",42,52,94,160,85,76,161,160,0.472049689440994,0.553191489361702,0.498039215686275,-0.0811417999207084
"Chr10","9372588","A","G",51,61,112,160,83,74,157,160,0.471337579617834,0.544642857142857,0.49814126394052,-0.0733052775250227
"Chr10","9372615","C","A",51,55,106,160,77,61,138,160,0.442028985507246,0.518867924528302,0.524590163934426,-0.0768389390210555
"Chr10","9372627","G","A",52,52,104,140,75,63,138,140,0.456521739130435,0.5,0.524793388429752,-0.0434782608695652
"Chr10","9372662","T","A",60,56,116,160,78,68,146,160,0.465753424657534,0.482758620689655,0.526717557251908,-0.017005196032121
"Chr10","9372850","C","T",67,64,131,160,96,66,162,160,0.407407407407407,0.488549618320611,0.556313993174061,-0.0811422109132033
"Chr10","9372929","G","C",70,67,137,141,95,67,162,141,0.41358024691358,0.489051094890511,0.551839464882943,-0.0754708479769307
"Chr10","9372945","A","G",71,70,141,137,106,70,176,137,0.397727272727273,0.49645390070922,0.558359621451104,-0.0987266279819471
"Chr10","9372970","T","C",82,76,158,142,111,75,186,142,0.403225806451613,0.481012658227848,0.561046511627907,-0.0777868517762352
"Chr10","9373082","T","C",70,73,143,160,92,74,166,160,0.44578313253012,0.510489510489511,0.524271844660194,-0.06470637795939
"Chr10","9373097","A","T",85,75,160,160,100,73,173,160,0.421965317919075,0.46875,0.555555555555556,-0.0467846820809248
"Chr10","9373144","T","A",76,67,143,142,77,60,137,142,0.437956204379562,0.468531468531469,0.546428571428571,-0.0305752641519065
"Chr10","9373279","A","G",81,92,173,160,100,83,183,160,0.453551912568306,0.531791907514451,0.508426966292135,-0.0782399949461448
"Chr10","9373291","C","A",77,96,173,136,104,85,189,136,0.44973544973545,0.554913294797688,0.5,-0.105177845062238
"Chr10","9373311","A","T",83,106,189,160,106,95,201,160,0.472636815920398,0.560846560846561,0.484615384615385,-0.0882097449261628
"Chr10","9373328","C","T",82,101,183,142,106,96,202,142,0.475247524752475,0.551912568306011,0.488311688311688,-0.0766650435535357
"Chr10","9373408","C","T",82,90,172,138,101,78,179,138,0.435754189944134,0.523255813953488,0.521367521367521,-0.0875016240093544
"Chr10","9373435","T","C",95,93,188,160,112,87,199,160,0.437185929648241,0.49468085106383,0.534883720930233,-0.0574949214155886
"Chr10","9373473","C","A",103,109,212,160,114,81,195,160,0.415384615384615,0.514150943396226,0.533169533169533,-0.0987663280116111
"Chr10","9373486","A","G",115,112,227,137,122,81,203,137,0.399014778325123,0.493392070484582,0.551162790697674,-0.0943772921594583
"Chr10","9373633","T","C",79,77,156,160,105,69,174,160,0.396551724137931,0.493589743589744,0.557575757575758,-0.0970380194518126
"Chr10","9373657","T","C",84,89,173,136,100,71,171,136,0.415204678362573,0.514450867052023,0.534883720930233,-0.0992461886894501
"Chr10","9373856","T","C",108,80,188,136,108,86,194,136,0.443298969072165,0.425531914893617,0.565445026178011,0.0177670541785479
"Chr10","9373862","A","G",109,82,191,136,106,92,198,136,0.464646464646465,0.429319371727749,0.552699228791774,0.0353270929187159
"Chr10","9373908","T","C",97,70,167,141,113,88,201,141,0.437810945273632,0.419161676646707,0.570652173913043,0.0186492686269253
"Chr10","9373934","A","T",88,78,166,144,112,88,200,144,0.44,0.469879518072289,0.546448087431694,-0.0298795180722892
"Chr10","9373943","T","C",89,76,165,146,109,88,197,146,0.446700507614213,0.460606060606061,0.546961325966851,-0.0139055529918474
"Chr10","9374002","G","A",78,84,162,160,98,88,186,160,0.473118279569892,0.518518518518518,0.505747126436782,-0.045400238948626
"Chr10","9374124","G","C",58,79,137,139,87,68,155,139,0.438709677419355,0.576642335766423,0.496575342465753,-0.137932658347068
"Chr10","9374180","A","T",52,68,120,142,61,72,133,142,0.541353383458647,0.566666666666667,0.446640316205534,-0.0253132832080201
"Chr10","9374190","T","C",56,78,134,160,69,76,145,160,0.524137931034483,0.582089552238806,0.448028673835125,-0.0579516212043232
"Chr10","9374213","T","C",59,92,151,138,91,97,188,138,0.515957446808511,0.609271523178808,0.442477876106195,-0.0933140763702973
"Chr10","9374483","C","T",68,68,136,140,84,70,154,140,0.454545454545455,0.5,0.524137931034483,-0.0454545454545455
"Chr10","9374492","C","T",63,67,130,146,80,63,143,146,0.440559440559441,0.515384615384615,0.523809523809524,-0.0748251748251748
"Chr10","9377798","C","A",72,68,140,137,75,82,157,137,0.522292993630573,0.485714285714286,0.494949494949495,0.0365787079162875
"Chr10","9377807","A","C",65,48,113,160,76,74,150,160,0.493333333333333,0.424778761061947,0.536121673003802,0.0685545722713864
"Chr10","9377851","C","T",48,45,93,144,71,65,136,144,0.477941176470588,0.483870967741935,0.519650655021834,-0.00592979127134724
"Chr10","9378124","A","C",47,20,67,139,39,53,92,139,0.576086956521739,0.298507462686567,0.540880503144654,0.277579493835172
"Chr10","9378138","C","A",43,21,64,160,36,55,91,160,0.604395604395604,0.328125,0.509677419354839,0.276270604395604
"Chr10","9378422","C","G",84,65,149,160,83,86,169,160,0.50887573964497,0.436241610738255,0.525157232704403,0.0726341289067154
"Chr10","9378488","T","C",87,54,141,160,80,90,170,160,0.529411764705882,0.382978723404255,0.536977491961415,0.146433041301627
"Chr10","9378543","A","G",71,50,121,160,69,63,132,160,0.477272727272727,0.413223140495868,0.553359683794466,0.0640495867768595
"Chr10","9378553","T","C",70,45,115,140,68,64,132,140,0.484848484848485,0.391304347826087,0.558704453441296,0.0935441370223979
"Chr10","9378584","A","T",52,51,103,160,57,51,108,160,0.472222222222222,0.495145631067961,0.516587677725118,-0.022923408845739
"Chr10","9378888","C","T",50,35,85,160,73,56,129,160,0.434108527131783,0.411764705882353,0.574766355140187,0.02234382124943
"Chr10","9378943","T","C",42,39,81,160,70,49,119,160,0.411764705882353,0.481481481481481,0.56,-0.0697167755991285
"Chr10","9379076","C","G",26,23,49,157,20,21,41,157,0.51219512195122,0.469387755102041,0.511111111111111,0.0428073668491787
"Chr10","9379098","T","C",23,22,45,160,16,21,37,160,0.567567567567568,0.488888888888889,0.475609756097561,0.0786786786786787
"Chr10","9379163","G","C",22,26,48,160,17,21,38,160,0.552631578947368,0.541666666666667,0.453488372093023,0.0109649122807018
"Chr10","9379197","A","G",17,22,39,160,27,17,44,160,0.386363636363636,0.564102564102564,0.530120481927711,-0.177738927738928
"Chr10","9379202","C","T",17,23,40,160,27,17,44,160,0.386363636363636,0.575,0.523809523809524,-0.188636363636364
"Chr10","9379249","G","A",15,15,30,143,17,21,38,143,0.552631578947368,0.5,0.470588235294118,0.0526315789473685
"Chr10","9379403","G","A",10,18,28,147,13,20,33,147,0.606060606060606,0.642857142857143,0.377049180327869,-0.0367965367965368
"Chr10","9379439","C","T",15,19,34,142,10,24,34,142,0.705882352941177,0.558823529411765,0.367647058823529,0.147058823529412
"Chr10","9379560","A","G",29,28,57,153,27,27,54,153,0.5,0.491228070175439,0.504504504504504,0.00877192982456143
"Chr10","9379650","A","C",35,31,66,141,40,37,77,141,0.480519480519481,0.46969696969697,0.524475524475524,0.0108225108225108
"Chr10","9379826","A","G",51,54,105,160,79,73,152,160,0.480263157894737,0.514285714285714,0.505836575875486,-0.0340225563909774
"Chr10","9380126","C","T",67,86,153,160,91,103,194,160,0.530927835051546,0.562091503267974,0.455331412103746,-0.0311636682164275
"Chr10","9380207","C","T",87,82,169,144,116,97,213,144,0.455399061032864,0.485207100591716,0.531413612565445,-0.0298080395588521
"Chr10","9380327","G","A",95,53,148,160,94,101,195,160,0.517948717948718,0.358108108108108,0.551020408163265,0.15984060984061
"Chr10","9380632","A","G",62,53,115,140,79,85,164,140,0.518292682926829,0.460869565217391,0.505376344086022,0.057423117709438
"Chr10","9380662","G","A",63,54,117,160,83,93,176,160,0.528409090909091,0.461538461538462,0.498293515358362,0.0668706293706294
"Chr10","9380686","T","C",68,57,125,160,75,91,166,160,0.548192771084337,0.456,0.491408934707904,0.0921927710843374
"Chr10","9380843","T","C",123,81,204,160,95,120,215,160,0.558139534883721,0.397058823529412,0.520286396181384,0.161080711354309
"Chr10","9380954","A","G",87,74,161,160,90,125,215,160,0.581395348837209,0.459627329192547,0.470744680851064,0.121768019644663
"Chr10","9381026","T","C",71,64,135,160,93,126,219,160,0.575342465753425,0.474074074074074,0.463276836158192,0.101268391679351
"Chr10","9381034","C","T",79,54,133,136,91,97,188,136,0.515957446808511,0.406015037593985,0.529595015576324,0.109942409214526
"Chr10","9381512","A","G",66,67,133,160,45,80,125,160,0.64,0.503759398496241,0.430232558139535,0.136240601503759
"Chr10","9381600","A","G",51,64,115,160,57,69,126,160,0.547619047619048,0.556521739130435,0.448132780082988,-0.00890269151138712
"Chr10","9381657","A","G",49,67,116,160,62,67,129,160,0.51937984496124,0.577586206896552,0.453061224489796,-0.0582063619353114
"Chr10","9381701","A","G",44,56,100,146,66,64,130,146,0.492307692307692,0.56,0.478260869565217,-0.0676923076923077
"Chr10","9381817","T","C",61,60,121,142,66,80,146,142,0.547945205479452,0.495867768595041,0.47565543071161,0.0520774368844107
"Chr10","9381843","T","C",62,61,123,160,61,68,129,160,0.527131782945736,0.495934959349593,0.488095238095238,0.031196823596143
"Chr10","9381965","G","A",46,54,100,160,43,57,100,160,0.57,0.54,0.445,0.0299999999999999
"Chr10","9382014","G","A",44,40,84,160,35,45,80,160,0.5625,0.476190476190476,0.481707317073171,0.0863095238095238
"Chr10","9382036","T","C",41,31,72,160,35,50,85,160,0.588235294117647,0.430555555555556,0.484076433121019,0.157679738562091
"Chr10","9382153","T","C",65,63,128,137,66,98,164,137,0.597560975609756,0.4921875,0.448630136986301,0.105373475609756
"Chr10","9382418","G","A",125,71,196,140,122,131,253,140,0.517786561264822,0.362244897959184,0.55011135857461,0.155541663305638
"Chr10","9382545","A","C",81,70,151,160,68,83,151,160,0.549668874172185,0.463576158940397,0.493377483443709,0.0860927152317881
"Chr10","9382557","A","G",71,76,147,138,65,78,143,138,0.545454545454545,0.517006802721088,0.468965517241379,0.028447742733457
"Chr10","9382579","G","A",75,71,146,160,70,66,136,160,0.485294117647059,0.486301369863014,0.514184397163121,-0.00100725221595488
"Chr10","9382608","A","G",74,75,149,144,62,81,143,144,0.566433566433566,0.503355704697987,0.465753424657534,0.0630778617355798
"Chr10","9382660","A","G",63,82,145,160,76,89,165,160,0.539393939393939,0.56551724137931,0.448387096774194,-0.0261233019853709
"Chr10","9382874","C","T",53,72,125,142,80,104,184,142,0.565217391304348,0.576,0.43042071197411,-0.0107826086956522
"Chr10","9383002","A","C",72,79,151,139,75,81,156,139,0.519230769230769,0.52317880794702,0.478827361563518,-0.0039480387162506
"Chr10","9383062","C","T",78,75,153,137,76,92,168,137,0.547619047619048,0.490196078431373,0.479750778816199,0.0574229691876751
"Chr10","9383116","A","G",67,64,131,160,64,81,145,160,0.558620689655172,0.488549618320611,0.47463768115942,0.0700710713345618
"Chr10","9383169","C","T",65,53,118,160,75,108,183,160,0.590163934426229,0.449152542372881,0.465116279069767,0.141011392053348
"Chr10","9383241","T","G",94,70,164,160,91,119,210,160,0.566666666666667,0.426829268292683,0.494652406417112,0.139837398373984
"Chr10","9383416","T","C",76,54,130,160,87,92,179,160,0.513966480446927,0.415384615384615,0.527508090614887,0.098581865062312
"Chr10","9383424","T","C",75,53,128,160,91,90,181,160,0.497237569060773,0.4140625,0.537216828478964,0.0831750690607735
"Chr10","9383538","T","C",83,61,144,160,65,101,166,160,0.608433734939759,0.423611111111111,0.47741935483871,0.184822623828648
"Chr10","9383724","C","G",69,75,144,160,81,116,197,160,0.588832487309645,0.520833333333333,0.439882697947214,0.0679991539763113
"Chr10","9383755","C","T",61,73,134,160,78,112,190,160,0.589473684210526,0.544776119402985,0.429012345679012,0.0446975648075412
"Chr10","9383804","A","C",76,78,154,160,79,97,176,160,0.551136363636364,0.506493506493506,0.46969696969697,0.0446428571428572
"Chr10","9383838","T","C",64,60,124,160,86,75,161,160,0.46583850931677,0.483870967741935,0.526315789473684,-0.0180324584251653
"Chr10","9400454","T","C",62,50,112,138,80,71,151,138,0.470198675496689,0.446428571428571,0.539923954372624,0.0237701040681173
"Chr10","9400498","T","C",61,54,115,160,79,73,152,160,0.480263157894737,0.469565217391304,0.524344569288389,0.0106979405034325
"Chr10","9401039","A","G",26,34,60,160,30,35,65,160,0.538461538461538,0.566666666666667,0.448,-0.0282051282051282
"Chr10","9402353","C","T",65,40,105,160,73,63,136,160,0.463235294117647,0.380952380952381,0.572614107883817,0.0822829131652661
"Chr10","9402440","C","A",64,50,114,144,73,61,134,144,0.455223880597015,0.43859649122807,0.55241935483871,0.0166273893689448
"Chr10","9402449","C","G",63,58,121,160,75,71,146,160,0.486301369863014,0.479338842975207,0.51685393258427,0.00696252688780707
"Chr10","9402504","C","T",61,60,121,140,69,68,137,140,0.496350364963504,0.495867768595041,0.503875968992248,0.000482596368462318
"Chr10","9402563","T","C",64,85,149,160,88,90,178,160,0.50561797752809,0.570469798657718,0.464831804281346,-0.0648518211296282
"Chr10","9402605","C","T",67,79,146,141,57,90,147,141,0.612244897959184,0.541095890410959,0.42320819112628,0.0711490075482247
"Chr10","9402661","C","T",76,73,149,139,65,96,161,139,0.596273291925466,0.48993288590604,0.454838709677419,0.106340406019426
"Chr10","9402676","A","G",68,64,132,160,60,84,144,160,0.583333333333333,0.484848484848485,0.463768115942029,0.0984848484848485
"Chr10","9405025","G","A",25,20,45,154,23,37,60,154,0.616666666666667,0.444444444444444,0.457142857142857,0.172222222222222
"Chr10","9405067","A","G",20,17,37,160,27,38,65,160,0.584615384615385,0.459459459459459,0.46078431372549,0.125155925155925
"Chr10","9405111","C","G",16,16,32,143,24,38,62,143,0.612903225806452,0.5,0.425531914893617,0.112903225806452
"Chr10","9405192","G","A",23,20,43,160,34,29,63,160,0.46031746031746,0.465116279069767,0.537735849056604,-0.00479881875230714
"Chr10","9405509","A","G",32,30,62,152,32,48,80,152,0.6,0.483870967741935,0.450704225352113,0.116129032258064
"Chr10","9405609","A","G",37,36,73,160,34,48,82,160,0.585365853658537,0.493150684931507,0.458064516129032,0.0922151687270297
"Chr10","9405630","C","T",28,36,64,160,30,36,66,160,0.545454545454545,0.5625,0.446153846153846,-0.0170454545454546
"Chr10","9405837","A","G",42,32,74,160,38,55,93,160,0.591397849462366,0.432432432432432,0.479041916167665,0.158965417029933
"Chr10","9410075","G","A",39,42,81,160,28,57,85,160,0.670588235294118,0.518518518518518,0.403614457831325,0.152069716775599
"Chr10","9410137","C","T",40,49,89,141,29,53,82,141,0.646341463414634,0.550561797752809,0.403508771929825,0.0957796656618252
"Chr10","9410293","A","G",37,36,73,160,32,53,85,160,0.623529411764706,0.493150684931507,0.436708860759494,0.130378726833199
"Chr10","9410316","A","G",35,39,74,160,28,47,75,160,0.626666666666667,0.527027027027027,0.422818791946309,0.0996396396396397
"Chr10","9410352","C","A",37,40,77,160,35,46,81,160,0.567901234567901,0.519480519480519,0.455696202531646,0.0484207150873818
"Chr10","9410574","C","T",53,34,87,146,43,52,95,146,0.547368421052632,0.390804597701149,0.527472527472527,0.156563823351482
"Chr10","9410653","T","C",56,33,89,141,45,49,94,141,0.521276595744681,0.370786516853933,0.551912568306011,0.150490078890748
"Chr10","9410667","C","T",57,29,86,160,44,48,92,160,0.521739130434783,0.337209302325581,0.567415730337079,0.184529828109201
"Chr10","9410682","G","A",61,32,93,138,37,52,89,138,0.584269662921348,0.344086021505376,0.538461538461538,0.240183641415972
"Chr10","9410697","A","G",48,31,79,160,40,49,89,160,0.550561797752809,0.392405063291139,0.523809523809524,0.15815673446167
"Chr10","9410759","A","C",40,25,65,139,46,50,96,139,0.520833333333333,0.384615384615385,0.53416149068323,0.136217948717949
"Chr10","9410776","G","A",38,26,64,160,49,52,101,160,0.514851485148515,0.40625,0.527272727272727,0.108601485148515
"Chr10","9410911","C","T",44,26,70,139,36,58,94,139,0.617021276595745,0.371428571428571,0.48780487804878,0.245592705167173
"Chr10","9411176","G","A",37,23,60,160,40,40,80,160,0.5,0.383333333333333,0.55,0.116666666666667
"Chr10","9411192","G","C",45,29,74,160,47,45,92,160,0.489130434782609,0.391891891891892,0.55421686746988,0.0972385428907168
"Chr10","9411378","C","A",40,31,71,142,44,49,93,142,0.526881720430108,0.436619718309859,0.51219512195122,0.0902620021202484
"Chr10","9411697","C","T",24,27,51,147,31,42,73,147,0.575342465753425,0.529411764705882,0.443548387096774,0.0459307010475423
"Chr10","9412040","C","T",33,31,64,160,28,56,84,160,0.666666666666667,0.484375,0.412162162162162,0.182291666666667
"Chr10","9412202","T","C",26,49,75,138,57,65,122,138,0.532786885245902,0.653333333333333,0.421319796954315,-0.120546448087432
"Chr10","9412611","T","C",19,27,46,160,28,30,58,160,0.517241379310345,0.58695652173913,0.451923076923077,-0.0697151424287856
"Chr10","9413234","T","G",7,10,17,94,4,1,5,14,0.2,0.588235294117647,0.5,-0.388235294117647
"Chr10","9413363","G","A",8,16,24,138,8,12,20,137,0.6,0.666666666666667,0.363636363636364,-0.0666666666666667
"Chr10","9413379","G","C",8,17,25,137,7,13,20,140,0.65,0.68,0.333333333333333,-0.03
"Chr10","9413398","C","T",10,15,25,141,9,17,26,141,0.653846153846154,0.6,0.372549019607843,0.0538461538461539
"Chr10","9413905","T","G",53,77,130,160,65,67,132,160,0.507575757575758,0.592307692307692,0.450381679389313,-0.0847319347319347
"Chr10","9414081","A","C",81,89,170,137,80,84,164,137,0.51219512195122,0.523529411764706,0.482035928143713,-0.0113342898134864
"Chr10","9414368","G","A",60,81,141,143,58,91,149,143,0.610738255033557,0.574468085106383,0.406896551724138,0.036270169927174
"Chr10","9414381","A","T",58,80,138,140,58,93,151,140,0.615894039735099,0.579710144927536,0.401384083044983,0.0361838948075631
"Chr10","9417086","G","A",105,60,165,137,88,125,213,137,0.586854460093897,0.363636363636364,0.510582010582011,0.223218096457533
"Chr10","9417484","A","G",62,58,120,160,70,108,178,160,0.606741573033708,0.483333333333333,0.442953020134228,0.123408239700375
"Chr10","9419195","G","A",93,64,157,160,102,92,194,160,0.474226804123711,0.407643312101911,0.555555555555556,0.0665834920218005
"Chr10","9419754","T","C",56,56,112,139,82,99,181,139,0.546961325966851,0.5,0.47098976109215,0.0469613259668509
"Chr10","9420050","G","A",33,43,76,151,42,58,100,151,0.58,0.565789473684211,0.426136363636364,0.0142105263157895
"Chr10","9420451","A","G",40,52,92,160,43,67,110,160,0.609090909090909,0.565217391304348,0.410891089108911,0.0438735177865613
"Chr10","9421126","T","C",40,45,85,141,46,71,117,141,0.606837606837607,0.529411764705882,0.425742574257426,0.0774258421317244
"Chr10","9421399","C","T",68,59,127,160,62,88,150,160,0.586666666666667,0.464566929133858,0.469314079422383,0.122099737532808
"Chr10","9421484","T","C",43,48,91,142,52,62,114,142,0.543859649122807,0.527472527472527,0.463414634146341,0.0163871216502796
"Chr10","9421522","T","C",49,46,95,140,60,70,130,140,0.538461538461538,0.484210526315789,0.484444444444444,0.054251012145749
"Chr10","9421726","C","G",65,59,124,144,75,69,144,144,0.479166666666667,0.475806451612903,0.522388059701492,0.00336021505376344
"Chr10","9421829","T","C",73,67,140,160,75,75,150,160,0.5,0.478571428571429,0.510344827586207,0.0214285714285714
"Chr10","9423455","G","A",44,24,68,160,37,46,83,160,0.55421686746988,0.352941176470588,0.536423841059603,0.201275690999291
"Chr10","9423570","A","G",30,48,78,146,32,37,69,146,0.536231884057971,0.615384615384615,0.421768707482993,-0.0791527313266444
"Chr10","9423639","G","A",62,42,104,160,60,52,112,160,0.464285714285714,0.403846153846154,0.564814814814815,0.0604395604395604
"Chr10","9423831","T","C",44,58,102,160,43,48,91,160,0.527472527472527,0.568627450980392,0.450777202072539,-0.0411549235078646
"Chr10","9424111","T","G",53,60,113,147,60,73,133,147,0.548872180451128,0.530973451327434,0.459349593495935,0.0178987291236942
"Chr10","9429105","A","G",11,17,28,153,16,20,36,153,0.555555555555556,0.607142857142857,0.421875,-0.0515873015873015
"Chr10","9440789","C","G",40,23,63,145,35,32,67,145,0.477611940298507,0.365079365079365,0.576923076923077,0.112532575219142
"Chr10","9441187","C","G",59,60,119,160,83,63,146,160,0.431506849315068,0.504201680672269,0.535849056603774,-0.0726948313572004
"Chr10","9441193","T","G",55,58,113,140,82,58,140,140,0.414285714285714,0.513274336283186,0.541501976284585,-0.0989886219974715
"Chr10","9441230","A","G",61,57,118,151,72,73,145,151,0.503448275862069,0.483050847457627,0.505703422053232,0.0203974284044419
"Chr10","9452210","G","C",46,33,79,160,44,60,104,160,0.576923076923077,0.417721518987342,0.491803278688525,0.159201557935735
"Chr10","9457456","G","A",51,37,88,160,42,47,89,160,0.528089887640449,0.420454545454545,0.525423728813559,0.107635342185904
"Chr10","9458678","T","A",14,12,26,147,20,21,41,147,0.51219512195122,0.461538461538462,0.507462686567164,0.050656660412758
"Chr10","9458840","C","T",11,6,17,140,18,11,29,160,0.379310344827586,0.352941176470588,0.630434782608696,0.0263691683569979
"Chr10","9494749","G","T",51,49,100,160,56,54,110,160,0.490909090909091,0.49,0.509523809523809,0.000909090909090915
"Chr10","9520420","A","G",51,80,131,160,79,68,147,160,0.462585034013605,0.610687022900763,0.467625899280576,-0.148101988887158
"Chr10","9538123","C","G",38,49,87,139,59,52,111,139,0.468468468468468,0.563218390804598,0.48989898989899,-0.0947499223361292
"Chr10","9549294","G","T",32,46,78,160,62,46,108,160,0.425925925925926,0.58974358974359,0.505376344086022,-0.163817663817664
"Chr10","9555272","A","G",12,5,17,77,11,9,20,142,0.45,0.294117647058824,0.621621621621622,0.155882352941176
"Chr10","9557129","A","G",81,101,182,137,133,110,243,137,0.452674897119342,0.554945054945055,0.503529411764706,-0.102270157825713
"Chr10","9561253","T","A",23,37,60,145,31,37,68,145,0.544117647058823,0.616666666666667,0.421875,-0.0725490196078432
"Chr10","10110846","T","C",1,1,2,2,3,0,3,17,0,0.5,0.8,-0.5
"Chr10","11817971","A","G",92,70,162,143,80,109,189,143,0.576719576719577,0.432098765432099,0.49002849002849,0.144620811287478
"Chr10","13361920","C","G",38,42,80,160,45,62,107,160,0.579439252336449,0.525,0.443850267379679,0.0544392523364485
"Chr10","16029751","G","A",14,20,34,160,20,24,44,160,0.545454545454545,0.588235294117647,0.435897435897436,-0.0427807486631017
"Chr10","18112733","G","A",66,44,110,142,57,73,130,142,0.561538461538462,0.4,0.5125,0.161538461538462
"Chr10","18584022","A","T",93,68,161,138,92,102,194,138,0.525773195876289,0.422360248447205,0.52112676056338,0.103412947429084
"Chr10","18810903","G","A",49,36,85,160,38,57,95,160,0.6,0.423529411764706,0.483333333333333,0.176470588235294
"Chr10","18813256","G","C",23,31,54,160,38,34,72,160,0.472222222222222,0.574074074074074,0.484126984126984,-0.101851851851852
"Chr10","19041787","G","A",10,4,14,55,14,4,18,22,0.222222222222222,0.285714285714286,0.75,-0.0634920634920635
"Chr10","19103747","C","T",10,19,29,57,23,17,40,117,0.425,0.655172413793103,0.478260869565217,-0.230172413793103
"Chr10","19175954","C","T",1,7,8,17,2,5,7,11,0.714285714285714,0.875,0.2,-0.160714285714286
"Chr10","19175972","T","A",2,7,9,9,2,5,7,10,0.714285714285714,0.777777777777778,0.25,-0.0634920634920635
"Chr10","19176002","G","A",2,5,7,0,2,5,7,10,0.714285714285714,0.714285714285714,0.285714285714286,0
"Chr10","19176007","C","T",2,5,7,15,2,5,7,9,0.714285714285714,0.714285714285714,0.285714285714286,0
"Chr10","19176017","G","A",2,5,7,0,2,4,6,23,0.666666666666667,0.714285714285714,0.307692307692308,-0.0476190476190477
"Chr10","19559892","C","T",7,11,18,0,8,6,14,12,0.428571428571429,0.611111111111111,0.46875,-0.182539682539683
"Chr10","19559898","C","G",8,10,18,8,8,6,14,10,0.428571428571429,0.555555555555556,0.5,-0.126984126984127
"Chr10","20284296","C","T",57,48,105,141,49,46,95,141,0.484210526315789,0.457142857142857,0.53,0.0270676691729324
"Chr10","20759404","C","A",49,64,113,160,67,72,139,160,0.517985611510791,0.566371681415929,0.46031746031746,-0.0483860699051378
"Chr10","20852657","C","T",15,3,18,50,16,4,20,71,0.2,0.166666666666667,0.815789473684211,0.0333333333333334
"Chr10","21173917","G","T",25,28,53,160,30,26,56,160,0.464285714285714,0.528301886792453,0.504587155963303,-0.0640161725067385
"Chr10","22290184","T","C",37,38,75,146,36,36,72,146,0.5,0.506666666666667,0.496598639455782,-0.00666666666666671
"Chr10","25231522","G","A",58,64,122,140,85,73,158,140,0.462025316455696,0.524590163934426,0.510714285714286,-0.06256484747873
"Chr10","25323550","G","A",31,19,50,61,21,18,39,91,0.461538461538462,0.38,0.584269662921348,0.0815384615384616
"Chr10","26951853","G","C",67,64,131,160,72,94,166,160,0.566265060240964,0.488549618320611,0.468013468013468,0.0777154419203532
"Chr10","27122123","C","T",30,31,61,146,24,34,58,146,0.586206896551724,0.508196721311475,0.453781512605042,0.0780101752402487
"Chr10","28449859","T","C",6,16,22,0,10,21,31,59,0.67741935483871,0.727272727272727,0.30188679245283,-0.0498533724340177
"Chr10","28561875","T","C",17,22,39,2,29,16,45,154,0.355555555555556,0.564102564102564,0.547619047619048,-0.208547008547009
"Chr10","32233440","T","A",28,14,42,49,21,17,38,0,0.447368421052632,0.333333333333333,0.6125,0.114035087719298
"Chr10","32320875","G","A",9,19,28,26,19,29,48,82,0.604166666666667,0.678571428571429,0.368421052631579,-0.074404761904762
"Chr10","32370733","T","C",8,2,10,1,11,4,15,10,0.266666666666667,0.2,0.76,0.0666666666666667
"Chr10","32395618","C","T",22,14,36,129,24,19,43,90,0.441860465116279,0.388888888888889,0.582278481012658,0.0529715762273902
"Chr10","32473198","C","G",8,28,36,42,13,39,52,28,0.75,0.777777777777778,0.238636363636364,-0.0277777777777778
"Chr10","32473236","T","C",1,35,36,125,8,46,54,115,0.851851851851852,0.972222222222222,0.1,-0.12037037037037
"Chr10","32643458","C","T",1,1,2,1,2,7,9,1,0.777777777777778,0.5,0.272727272727273,0.277777777777778
"Chr10","32715563","G","A",4,2,6,1,3,4,7,9,0.571428571428571,0.333333333333333,0.538461538461538,0.238095238095238
"Chr10","34378147","A","C",7,8,15,47,7,4,11,0,0.363636363636364,0.533333333333333,0.538461538461538,-0.16969696969697
"Chr10","34403629","T","C",7,8,15,0,21,3,24,63,0.125,0.533333333333333,0.717948717948718,-0.408333333333333
"Chr10","35187568","A","T",94,112,206,160,91,135,226,160,0.597345132743363,0.543689320388349,0.428240740740741,0.0536558123550134
"Chr10","35802874","T","C",56,87,143,134,77,89,166,134,0.536144578313253,0.608391608391608,0.43042071197411,-0.0722470300783554
"Chr10","36610280","G","A",11,11,22,36,25,3,28,59,0.107142857142857,0.5,0.72,-0.392857142857143
"Chr10","37303042","T","G",82,75,157,136,81,102,183,136,0.557377049180328,0.477707006369427,0.479411764705882,0.0796700428109011
"Chr10","38188510","C","T",5,0,5,24,14,1,15,47,0.0666666666666667,0,0.95,0.0666666666666667
"Chr10","38258706","C","A",68,59,127,140,50,65,115,140,0.565217391304348,0.464566929133858,0.487603305785124,0.10065046217049
"Chr10","38300291","T","C",19,12,31,113,21,15,36,138,0.416666666666667,0.387096774193548,0.597014925373134,0.0295698924731183
"Chr10","38351095","A","C",39,32,71,93,48,54,102,107,0.529411764705882,0.450704225352113,0.502890173410405,0.0787075393537697
"Chr10","38941666","G","A",37,55,92,160,42,65,107,160,0.607476635514019,0.597826086956522,0.396984924623116,0.00965054855749692
"Chr10","39047309","G","A",15,13,28,131,22,28,50,8,0.56,0.464285714285714,0.474358974358974,0.0957142857142858
"Chr10","39631083","G","A",10,2,12,42,10,0,10,40,0,0.166666666666667,0.909090909090909,-0.166666666666667
"Chr10","40251322","C","T",10,11,21,75,10,11,21,28,0.523809523809524,0.523809523809524,0.476190476190476,0
"Chr10","40435706","G","T",5,16,21,25,3,22,25,58,0.88,0.761904761904762,0.173913043478261,0.118095238095238
"Chr10","40629997","C","T",13,3,16,25,16,3,19,40,0.157894736842105,0.1875,0.828571428571429,-0.0296052631578947
"Chr10","41476873","T","C",1,14,15,64,5,18,23,4,0.782608695652174,0.933333333333333,0.157894736842105,-0.150724637681159
"Chr10","41501716","A","G",96,134,230,160,143,156,299,160,0.521739130434783,0.582608695652174,0.45179584120983,-0.0608695652173913
"Chr10","42150108","G","C",35,46,81,160,40,29,69,160,0.420289855072464,0.567901234567901,0.5,-0.147611379495437
"Chr10","44840833","G","T",1,0,1,6,NA,NA,NA,NA,NA,0,NA,NA
"Chr10","45387354","C","T",66,56,122,160,75,68,143,160,0.475524475524476,0.459016393442623,0.532075471698113,0.0165080820818526
"Chr10","47184654","A","G",68,77,145,160,77,109,186,160,0.586021505376344,0.531034482758621,0.438066465256798,0.0549870226177235
"Chr10","47265092","C","T",92,90,182,160,113,123,236,160,0.521186440677966,0.494505494505495,0.490430622009569,0.0266809461724716
"Chr10","47818634","C","A",23,31,54,145,20,37,57,145,0.649122807017544,0.574074074074074,0.387387387387387,0.0750487329434698
"Chr10","48107001","G","A",69,65,134,144,48,53,101,144,0.524752475247525,0.485074626865672,0.497872340425532,0.0396778483818531
"Chr10","48644358","C","T",35,57,92,160,43,51,94,160,0.542553191489362,0.619565217391304,0.419354838709677,-0.0770120259019427
"Chr10","49394353","C","T",2,5,7,37,2,2,4,4,0.5,0.714285714285714,0.363636363636364,-0.214285714285714
"Chr10","50611637","G","A",41,35,76,142,45,32,77,142,0.415584415584416,0.460526315789474,0.562091503267974,-0.0449419002050581
"Chr10","50770370","A","T",29,15,44,149,57,44,101,149,0.435643564356436,0.340909090909091,0.593103448275862,0.0947344734473448
"Chr10","50827794","G","A",36,28,64,160,28,40,68,160,0.588235294117647,0.4375,0.484848484848485,0.150735294117647
"Chr10","51415850","G","A",42,42,84,139,72,55,127,139,0.433070866141732,0.5,0.540284360189573,-0.0669291338582677
"Chr10","54655551","T","C",10,12,22,55,18,11,29,72,0.379310344827586,0.545454545454545,0.549019607843137,-0.166144200626959
"Chr10","58790779","A","G",24,21,45,135,29,22,51,160,0.431372549019608,0.466666666666667,0.552083333333333,-0.0352941176470588
